## 超强3简 使用deal_super_3jian.py生成
啊啊啊	aaa/
岙岸村	aac/
暗暗地	aad/
挨挨儿	aae/
爱奥华	aah/
嗷嗷叫	aaj/
嗷嗷冷	aal/
艾安琪	aaq/
按安置	aav/
艾奥瓦	aaw/
昂昂溪	aax/
爱爱医	aay/
爱不爱	aba/
阿巴巴	abb/
熬不到	abd/
挨班儿	abe/
阿爸父	abf/
熬不过	abg/
奥本海	abh/
爱泊车	abi/
阿布贾	abj/
奥比克	abk/
按比例	abl/
奥巴马	abm/
安瓿瓶	abp/
挨不起	abq/
阿比让	abr/
阿巴斯	abs/
按不同	abt/
安不上	abu/
按标准	abv/
阿波舞	abw/
阿坝县	abx/
爱彼迎	aby/
挨板子	abz/
爱词霸	acb/
挨呲儿	ace/
奥村春	aci/
按错键	acj/
按错了	acl/
艾参谋	acm/
安次区	acq/
奥藏山	acu/
暗藏着	acv/
按次序	acx/
昂刺鱼	acy/
矮矬子	acz/
爱丁堡	adb/
安东村	adc/
按当地	add/
爱迪尔	ade/
阿道夫	adf/
爱的歌	adg/
爱德华	adh/
奥迪车	adi/
埃德加	adj/
阿达克	adk/
奥地利	adl/
安定门	adm/
安东尼	adn/
安定片	adp/
爱得起	adq/
爱的人	adr/
奥德赛	ads/
奥迪特	adt/
爱迪生	adu/
哀悼者	adv/
阿达娃	adw/
安达信	adx/
安定药	ady/
阿弟仔	adz/
阿尔巴	aeb/
埃尔顿	aed/
阿尔法	aef/
埃尔金	aej/
阿尔卡	aek/
爱尔兰	ael/
奥尔莫	aem/
爱尔妮	aen/
阿尔派	aep/
埃尔切	aeq/
爱耳日	aer/
爱尔思	aes/
阿尔泰	aet/
阿尔山	aeu/
艾尔文	aew/
爱尔香	aex/
阿尔兹	aez/
埃弗顿	afd/
埃菲尔	afe/
阿法狗	afg/
阿富汗	afh/
案犯家	afj/
啊服啦	afl/
奥菲曼	afm/
安芬尼	afn/
案发前	afq/
阿芙蓉	afr/
艾弗森	afs/
阿凡提	aft/
案发时	afu/
爱抚着	afv/
安福县	afx/
暗反应	afy/
安放在	afz/
阿古柏	agb/
爱国村	agc/
按规定	agd/
挨个儿	age/
爱国法	agf/
按规格	agg/
爱国会	agh/
按国家	agj/
安哥拉	agl/
啊哥们	agm/
爱过你	agn/
昂贵品	agp/
按过去	agq/
奥国人	agr/
安格斯	ags/
阿根廷	agt/
安国市	agu/
爱国者	agv/
爱过我	agw/
爱国心	agx/
熬个夜	agy/
矮个子	agz/
氨磺胺	aha/
安徽菜	ahc/
暗号的	ahd/
安赫尔	ahe/
爱何辜	ahg/
阿哈湖	ahh/
按回车	ahi/
阿含经	ahj/
阿洪口	ahk/
安慧里	ahl/
安魂曲	ahq/
矮黑人	ahr/
暗红色	ahs/
按合同	aht/
安徽省	ahu/
爱好者	ahv/
螯合物	ahw/
安化县	ahx/
按行业	ahy/
爱还在	ahz/
爱吃啊	aia/
爱吃醋	aic/
鹌鹑蛋	aid/
阿閦佛	aif/
按常规	aig/
澳储行	aih/
暗沉沉	aii/
氨茶碱	aij/
爱车狂	aik/
按出来	ail/
爱出猫	aim/
阿城区	aiq/
爱车人	air/
熬出头	ait/
按察使	aiu/
昂船洲	aiv/
安初夏	aix/
爱吃鱼	aiy/
阿昌族	aiz/
爱就爱	aja/
按基本	ajb/
安钧璨	ajc/
安静的	ajd/
安吉尔	aje/
奥井枫	ajf/
阿姐鼓	ajg/
按计划	ajh/
艾景初	aji/
安监局	ajj/
安居卡	ajk/
安静了	ajl/
安检门	ajm/
阿基诺	ajn/
阿桔片	ajp/
凹进去	ajq/
埃及人	ajr/
氨基酸	ajs/
氨基糖	ajt/
案件时	aju/
案件中	ajv/
安居网	ajw/
安吉县	ajx/
按键音	ajy/
阿吉仔	ajz/
按可比	akb/
爱哭的	akd/
按扣儿	ake/
按空格	akg/
奥科查	aki/
阿坎吉	akj/
𩽾𩾌科	akk/
奥克兰	akl/
澳柯玛	akm/
阿奎纳	akn/
艾肯泉	akq/
奥克斯	aks/
阿克陶	akt/
安康市	aku/
安康站	akv/
爱看网	akw/
爱科学	akx/
安科院	aky/
暗刻子	akz/
阿利安	ala/
阿拉伯	alb/
按两次	alc/
奥兰多	ald/
阿拉尔	ale/
奥利弗	alf/
阿拉贡	alg/
安理会	alh/
安陵君	alj/
埃里克	alk/
熬烂了	all/
阿拉姆	alm/
暗恋你	aln/
艾莉欧	alo/
爱乐普	alp/
阿联酋	alq/
阿兰若	alr/
爱丽丝	als/
阿勒泰	alt/
按理说	alu/
暗恋着	alv/
安乐窝	alw/
爱立信	alx/
安乐椅	aly/
艾莉兹	alz/
爱没爱	ama/
安美波	amb/
按名次	amc/
澳门队	amd/
埃米尔	ame/
按摩法	amf/
按每个	amg/
奥马哈	amh/
奥美嘉	amj/
爱美丽	aml/
阿妹妹	amm/
阿玛尼	amn/
艾米潘	amp/
按摩器	amq/
按默认	amr/
阿霉素	ams/
熬米汤	amt/
按摩师	amu/
爱慕者	amv/
阿迈威	amw/
阿马逊	amx/
安眠药	amy/
爱面子	amz/
安宁村	anc/
按你的	and/
奥尼尔	ane/
阿那含	anh/
按钮处	ani/
安纳金	anj/
昂纳克	ank/
阿涅利	anl/
啊你妈	anm/
爱奶奶	ann/
爱你哦	ano/
安宁片	anp/
安宁区	anq/
按内容	anr/
阿诺斯	ans/
熬年头	ant/
按钮时	anu/
爱鸟周	anv/
安宁县	anx/
阿妮亚	any/
爱欧迪	aod/
艾欧娜	aon/
安排表	apb/
安平村	apc/
矮胖的	apd/
安排法	apf/
安排给	apg/
安排好	aph/
安瓢虫	api/
安培计	apj/
安排了	apl/
按排名	apm/
挨批评	app/
阿帕奇	apq/
爱骗人	apr/
爱普生	apu/
爱拍照	apv/
安排下	apx/
阿皮亚	apy/
矮胖子	apz/
安全部	aqb/
安全词	aqc/
安全的	aqd/
安琪儿	aqe/
安全法	aqf/
安全感	aqg/
爱琴海	aqh/
安全处	aqi/
安全局	aqj/
安全科	aqk/
安其拉	aql/
安全帽	aqm/
爱情鸟	aqn/
爱其欧	aqo/
爱情片	aqp/
安全期	aqq/
爱妻日	aqr/
安全司	aqs/
安全套	aqt/
安庆市	aqu/
哀求着	aqv/
安全网	aqw/
安全性	aqx/
按企业	aqy/
安全组	aqz/
澳人报	arb/
阿如村	arc/
奥瑞德	ard/
安若儿	are/
安仁坊	arf/
黯然谷	arg/
爱如火	arh/
熬乳茶	ari/
按人均	arj/
艾瑞克	ark/
艾瑞里	arl/
爱人民	arm/
艾瑞欧	aro/
阿荣旗	arq/
阿瑞斯	ars/
按人头	art/
安如山	aru/
阿日扎	arv/
安仁县	arx/
安若依	ary/
矮人族	arz/
奥赛班	asb/
暗色彩	asc/
奥斯达	asd/
阿萨尔	ase/
艾森豪	ash/
爱撒娇	asj/
奥斯卡	ask/
奥斯陆	asl/
奥斯曼	asm/
阿森纳	asn/
安三胖	asp/
艾思奇	asq/
奥司瑞	asr/
阿森松	ass/
奥斯汀	ast/
阿苏山	asu/
埃森哲	asv/
阿斯旺	asw/
安塞县	asx/
暗色岩	asy/
爱嫂子	asz/
安提阿	ata/
阿土伯	atb/
坳头村	atc/
铵态氮	atd/
熬头儿	ate/
凹凸感	atg/
爱同行	ath/
奥拓车	ati/
凹透镜	atj/
阿提拉	atl/
奥特曼	atm/
埃特纳	atn/
阿托品	atp/
挨铁拳	atq/
阿特苏	ats/
爱挑剔	att/
安徒生	atu/
安图县	atx/
安胎药	aty/
阿土仔	atz/
暗杀案	aua/
爱上兵	aub/
矮树丛	auc/
安师大	aud/
按省份	auf/
按时还	auh/
按市场	aui/
按市价	auj/
爱书狂	auk/
爱上了	aul/
啊什么	aum/
爱上你	aun/
爱书癖	aup/
爱生气	auq/
爱书人	aur/
奥氏体	aut/
鞍山市	auu/
暗示着	auv/
爱上我	auw/
按顺序	aux/
按手印	auy/
安睡在	auz/
案中案	ava/
安装包	avb/
安中村	avc/
安置地	avd/
啊这儿	ave/
安装费	avf/
按中国	avg/
安装后	avh/
安装场	avi/
按直接	avj/
安装了	avl/
矮种马	avm/
爱着你	avn/
安装盘	avp/
安贞桥	avq/
澳洲人	avr/
矮壮素	avs/
爱着他	avt/
安装时	avu/
按这种	avv/
安装完	avw/
爱知县	avx/
安装有	avy/
安装在	avz/
案外案	awa/
爱卫办	awb/
哎卧槽	awc/
阿瓦达	awd/
奥威尔	awe/
爱玩滚	awg/
奥委会	awh/
傲无常	awi/
安慰剂	awj/
阿威罗	awl/
爱我吗	awm/
安薇娜	awn/
爱网球	awq/
案外人	awr/
安慰赛	aws/
安慰他	awt/
爱玩耍	awu/
安慰着	awv/
艾窝窝	aww/
安位薰	awx/
按位与	awy/
阿佤族	awz/
癌细胞	axb/
爱心菜	axc/
矮小的	axd/
艾希尔	axe/
岸信夫	axf/
爱心果	axg/
俺喜欢	axh/
凹陷处	axi/
岸信介	axj/
爱心卡	axk/
阿修罗	axl/
按项目	axm/
安息年	axn/
按下去	axq/
安息日	axr/
爱相随	axs/
按系统	axt/
按下述	axu/
暗行者	axv/
爱香味	axw/
按现行	axx/
按协议	axy/
按现在	axz/
艾叶豹	ayb/
奥运村	ayc/
按一定	ayd/
阿尤恩	aye/
安逸飞	ayf/
按有关	ayg/
奥运会	ayh/
奥运钞	ayi/
凹印机	ayj/
奥运卡	ayk/
俺也来	ayl/
爱与美	aym/
挨一炮	ayp/
按要求	ayq/
爱牙日	ayr/
奥运赛	ays/
爱与痛	ayt/
安阳市	ayu/
按医嘱	ayv/
哎哟喂	ayw/
按一下	ayx/
哎呀呀	ayy/
暗夜紫	ayz/
艾滋病	azb/
肮脏的	azd/
艾泽尔	aze/
安葬费	azf/
爱祖国	azg/
安祖花	azh/
爱自己	azj/
阿兹卡	azk/
熬走了	azl/
按字母	azm/
艾滋女	azn/
爱自拍	azp/
岸在前	azq/
爱自然	azr/
暗紫色	azs/
鞍子山	azu/
安葬着	azv/
奥组委	azw/
拗造型	azx/
安祚永	azy/
爱咋咋	azz/
悲哀啊	baa/
保安部	bab/
保安村	bac/
不安的	bad/
不安分	baf/
不爱国	bag/
备案号	bah/
不爱吃	bai/
百安居	baj/
保安科	bak/
白熬了	bal/
倍氨敏	bam/
不爱你	ban/
被安排	bap/
宝安区	baq/
报案人	bar/
丙氨酸	bas/
不爱他	bat/
不按时	bau/
并按照	bav/
不爱我	baw/
不安心	bax/
保安员	bay/
保安族	baz/
苯丙胺	bba/
并不比	bbb/
并保存	bbc/
宝宝的	bbd/
傍边儿	bbe/
八宝饭	bbf/
本报告	bbg/
并不会	bbh/
并不长	bbi/
被绑架	bbj/
不包括	bbk/
颁布了	bbl/
本部门	bbm/
并不能	bbn/
别被喷	bbp/
北半球	bbq/
比别人	bbr/
并不算	bbs/
并把它	bbt/
并不是	bbu/
并保证	bbv/
北部湾	bbw/
本报讯	bbx/
不必要	bby/
并不在	bbz/
不错啊	bca/
不错吧	bcb/
便匆匆	bcc/
彼此的	bcd/
板擦儿	bce/
被采访	bcf/
不错过	bcg/
被摧毁	bch/
被刺穿	bci/
不参加	bcj/
补财库	bck/
不错了	bcl/
被赐名	bcm/
被采纳	bcn/
不错哦	bco/
扒层皮	bcp/
并采取	bcq/
并存入	bcr/
冰醋酸	bcs/
被辞退	bct/
并促使	bcu/
保存着	bcv/
保存为	bcw/
不曾想	bcx/
不参与	bcy/
不存在	bcz/
不对啊	bda/
不得不	bdb/
背单词	bdc/
不断地	bdd/
半点儿	bde/
贝多芬	bdf/
被低估	bdg/
本地化	bdh/
不动产	bdi/
不对劲	bdj/
病毒库	bdk/
表达了	bdl/
不点名	bdm/
不懂呢	bdn/
被打破	bdp/
本地区	bdq/
本地人	bdr/
不打算	bds/
半导体	bdt/
表达式	bdu/
变电站	bdv/
本单位	bdw/
不断向	bdx/
不低于	bdy/
被当作	bdz/
倍儿棒	beb/
板儿寸	bec/
博尔顿	bed/
不二法	bef/
巴尔干	beg/
北二环	beh/
丙二醇	bei/
布尔津	bej/
波尔卡	bek/
巴尔郎	bel/
鲍尔默	bem/
包二奶	ben/
本二批	bep/
丙二醛	beq/
白鹅绒	ber/
伯恩斯	bes/
棒儿糖	bet/
百二十	beu/
布尔值	bev/
贝尔温	bew/
板儿鞋	bex/
包二爷	bey/
巴尔赞	bez/
不妨碍	bfa/
不方便	bfb/
不服从	bfc/
百分点	bfd/
半疯儿	bfe/
被非法	bff/
不放过	bfg/
不符合	bfh/
爆发出	bfi/
播放机	bfj/
备份库	bfk/
颁发了	bfl/
本发明	bfm/
白发男	bfn/
包袱皮	bfp/
播放器	bfq/
部分人	bfr/
不放松	bfs/
巴菲特	bft/
办法是	bfu/
并发症	bfv/
被分为	bfw/
被发现	bfx/
暴风雨	bfy/
不负责	bfz/
并购案	bga/
不改变	bgb/
不光彩	bgc/
本规定	bgd/
白果儿	bge/
不规范	bgf/
不过关	bgg/
报告会	bgh/
不构成	bgi/
并根据	bgj/
不公开	bgk/
办公楼	bgl/
丙肝门	bgm/
被国内	bgn/
不过偶	bgo/
不公平	bgp/
办公区	bgq/
被告人	bgr/
本公司	bgs/
办公厅	bgt/
办公室	bgu/
办公桌	bgv/
变更为	bgw/
不高兴	bgx/
半个月	bgy/
不规则	bgz/
不好啊	bha/
不会被	bhb/
保护层	bhc/
不会对	bhd/
八孩儿	bhe/
不合法	bhf/
不合格	bhg/
保护好	bhh/
不好吃	bhi/
不回家	bhj/
不好看	bhk/
不合理	bhl/
保护膜	bhm/
不会弄	bhn/
不好哦	bho/
不害怕	bhp/
保护区	bhq/
被害人	bhr/
保护伞	bhs/
本合同	bht/
不会是	bhu/
包含着	bhv/
渤海湾	bhw/
不和谐	bhx/
不会有	bhy/
把孩子	bhz/
飙车案	bia/
病床边	bib/
不出错	bic/
不承担	bid/
白茬儿	bie/
补偿费	bif/
不超过	big/
病虫害	bih/
被查出	bii/
并出具	bij/
补偿款	bik/
变成了	bil/
不出门	bim/
并承诺	bin/
本产品	bip/
被拆迁	biq/
不承认	bir/
被处死	bis/
比传统	bit/
病床上	biu/
保持着	biv/
被称为	biw/
本程序	bix/
不迟于	biy/
保持在	biz/
绑架案	bja/
笔记本	bjb/
保健操	bjc/
北京的	bjd/
把角儿	bje/
比较法	bjf/
比较高	bjg/
比较好	bjh/
被检查	bji/
不仅仅	bjj/
不健康	bjk/
不见了	bjl/
比较慢	bjm/
比较难	bjn/
保健品	bjp/
编辑器	bjq/
北京人	bjr/
半决赛	bjs/
本集团	bjt/
北京市	bju/
被禁止	bjv/
比较晚	bjw/
背景下	bjx/
不具有	bjy/
败家子	bjz/
不坑啊	bka/
不可不	bkb/
被坑惨	bkc/
不可得	bkd/
把口儿	bke/
被开发	bkf/
被控告	bkg/
把客户	bkh/
被开除	bki/
不可见	bkj/
不可靠	bkk/
包括了	bkl/
不开门	bkm/
不可能	bkn/
不靠谱	bkp/
不客气	bkq/
报考人	bkr/
不扩散	bks/
报刊亭	bkt/
本科生	bku/
半空中	bkv/
不愧为	bkw/
不开心	bkx/
不可以	bky/
被看作	bkz/
报了案	bla/
白萝卜	blb/
不理睬	blc/
便利店	bld/
布莱尔	ble/
布洛芬	blf/
玻璃钢	blg/
博览会	blh/
暴露出	bli/
本来就	blj/
布莱克	blk/
暴露了	bll/
变量名	blm/
布兰妮	bln/
不赖哦	blo/
玻璃瓶	blp/
被录取	blq/
被列入	blr/
布鲁斯	bls/
本论坛	blt/
不论是	blu/
保留着	blv/
比例为	blw/
不履行	blx/
不利于	bly/
暴露在	blz/
罢免案	bma/
不明白	bmb/
蓖麻蚕	bmc/
报名点	bmd/
把妹儿	bme/
报名费	bmf/
把目光	bmg/
伯明翰	bmh/
报名处	bmi/
表面积	bmj/
北门口	bmk/
避免了	bml/
白茫茫	bmm/
本命年	bmn/
白马篇	bmp/
不明确	bmq/
冰美人	bmr/
白马寺	bms/
被媒体	bmt/
表面上	bmu/
报名者	bmv/
便民网	bmw/
不明显	bmx/
并没有	bmy/
不满足	bmz/
不能啊	bna/
不能不	bnb/
把农村	bnc/
本年度	bnd/
把女儿	bne/
不耐烦	bnf/
不能够	bng/
半年后	bnh/
比年初	bni/
不能急	bnj/
背囊客	bnk/
不努力	bnl/
不那么	bnm/
半年内	bnn/
保暖棚	bnp/
半年前	bnq/
不能让	bnr/
不能算	bns/
不能太	bnt/
不能说	bnu/
白内障	bnv/
不能忘	bnw/
把那些	bnx/
不能用	bny/
不能再	bnz/
布偶啊	boa/
布偶村	boc/
布偶猫	bom/
碧欧泉	boq/
北欧人	bor/
巴欧丝	bos/
被欧洲	bov/
拜偶像	box/
保平安	bpa/
并配备	bpb/
半瓶醋	bpc/
不平等	bpd/
包片儿	bpe/
不平凡	bpf/
包皮垢	bpg/
不平衡	bph/
不排除	bpi/
不平静	bpj/
不怕苦	bpk/
背叛了	bpl/
被拍卖	bpm/
背叛你	bpn/
不匹配	bpp/
变频器	bpq/
北平人	bpr/
不怕死	bps/
不配套	bpt/
白皮书	bpu/
被批准	bpv/
被评为	bpw/
被判刑	bpx/
不便宜	bpy/
宝瓶座	bpz/
不去啊	bqa/
并且把	bqb/
白千层	bqc/
并取得	bqd/
白求恩	bqe/
版权法	bqf/
版权归	bqg/
并且还	bqh/
不清楚	bqi/
版权局	bqj/
标签库	bqk/
冰淇淋	bql/
百千米	bqm/
比去年	bqn/
被欺骗	bqp/
不齐全	bqq/
被确认	bqr/
不起诉	bqs/
被其他	bqt/
并且是	bqu/
标签纸	bqv/
八千万	bqw/
被取消	bqx/
本企业	bqy/
并且在	bqz/
把日本	brb/
不认错	brc/
病人的	brd/
刨刃儿	bre/
不让放	brf/
不如归	brg/
必然会	brh/
辨认出	bri/
本软件	brj/
被认可	brk/
白扔了	brl/
被人们	brm/
比如你	brn/
败人品	brp/
白扔钱	brq/
不让人	brr/
不认怂	brs/
被人体	brt/
比如说	bru/
不认真	brv/
被认为	brw/
必然性	brx/
不容易	bry/
被扔在	brz/
比萨饼	bsb/
巴松错	bsc/
被锁定	bsd/
巴塞尔	bse/
巴斯夫	bsf/
变速杆	bsg/
北三环	bsh/
比赛场	bsi/
本赛季	bsj/
巴斯克	bsk/
病死率	bsl/
俾斯麦	bsm/
不死鸟	bsn/
被撕破	bsp/
变速器	bsq/
波斯人	bsr/
白森森	bss/
贝斯特	bst/
保送生	bsu/
伴随着	bsv/
被送往	bsw/
变速箱	bsx/
把所有	bsy/
卜算子	bsz/
不太矮	bta/
不同步	btb/
不听从	btc/
不同的	btd/
白天鹅	bte/
被推翻	btf/
并通过	btg/
本土化	bth/
不提倡	bti/
被推荐	btj/
不太肯	btk/
本条例	btl/
被他们	btm/
拜托你	btn/
不同品	btp/
趵突泉	btq/
被他人	btr/
被投诉	bts/
被淘汰	btt/
包头市	btu/
不停止	btv/
白头翁	btw/
不提醒	btx/
不同于	bty/
别太早	btz/
不是啊	bua/
不是不	bub/
本手册	buc/
波士顿	bud/
抱身儿	bue/
不舒服	buf/
不是个	bug/
不是很	buh/
办事处	bui/
被审计	buj/
不是靠	buk/
不说了	bul/
不是吗	bum/
比上年	bun/
不是哦	buo/
保守派	bup/
保税区	buq/
不少人	bur/
被杀死	bus/
白砂糖	but/
博士生	buu/
本书中	buv/
不是我	buw/
不实行	bux/
不少于	buy/
不识字	buz/
编者按	bva/
标准版	bvb/
把这次	bvc/
不知道	bvd/
本主儿	bve/
补助费	bvf/
把这个	bvg/
标准化	bvh/
不支持	bvi/
保证金	bvj/
被指控	bvk/
不住了	bvl/
标志码	bvm/
帮助你	bvn/
标志牌	bvp/
不正确	bvq/
班主任	bvr/
本周三	bvs/
抱住他	bvt/
不知是	bvu/
标志着	bvv/
包装物	bvw/
把这些	bvx/
本专业	bvy/
本准则	bvz/
部委办	bwb/
保温层	bwc/
不稳定	bwd/
鲍威尔	bwe/
八王坟	bwf/
博物馆	bwg/
把握好	bwh/
保卫处	bwi/
搬完家	bwj/
保卫科	bwk/
搬完了	bwl/
把我们	bwm/
比往年	bwn/
斑尾鸥	bwo/
保温瓶	bwp/
不完全	bwq/
被污染	bwr/
比完赛	bws/
把问题	bwt/
不完善	bwu/
本网站	bwv/
布娃娃	bww/
伴我行	bwx/
百万元	bwy/
帮我做	bwz/
不行啊	bxa/
必须把	bxb/
表现层	bxc/
表现的	bxd/
报信儿	bxe/
保险费	bxf/
不锈钢	bxg/
不喜欢	bxh/
表现出	bxi/
保险金	bxj/
必修课	bxk/
表现了	bxl/
本项目	bxm/
丙戌年	bxn/
不行哦	bxo/
必需品	bxp/
本学期	bxq/
保险人	bxr/
并迅速	bxs/
本系统	bxt/
半小时	bxu/
不限制	bxv/
表现为	bxw/
不小心	bxx/
不需要	bxy/
表现在	bxz/
鼻咽癌	bya/
不要把	byb/
并由此	byc/
必要的	byd/
白眼儿	bye/
被依法	byf/
不应该	byg/
毕业后	byh/
不远处	byi/
不要紧	byj/
不愉快	byk/
毕业了	byl/
不要命	bym/
比翼鸟	byn/
不要怕	byp/
变压器	byq/
不要让	byr/
白岩松	bys/
避孕套	byt/
毕业生	byu/
不一致	byv/
被誉为	byw/
不允许	byx/
不一样	byy/
不要在	byz/
不再爱	bza/
边走边	bzb/
并在此	bzc/
半自动	bzd/
白嘴儿	bze/
煲仔饭	bzf/
不足够	bzg/
不在乎	bzh/
不赞成	bzi/
把自己	bzj/
别走开	bzk/
不在了	bzl/
不怎么	bzm/
不再能	bzn/
本作品	bzp/
变奏曲	bzq/
不自然	bzr/
并赠送	bzs/
八字帖	bzt/
不再是	bzu/
并组织	bzv/
不作为	bzw/
不在线	bzx/
不足以	bzy/
不再做	bzz/
蹭啊蹭	cac/
曾爱过	cag/
残奥会	cah/
曹安路	cal/
曹安民	cam/
错阿乡	cax/
采编部	cbb/
存不存	cbc/
粗暴的	cbd/
葱白儿	cbe/
猜比分	cbf/
挫败感	cbg/
才不会	cbh/
猜不出	cbi/
仓本堇	cbj/
藏宝库	cbk/
漕宝路	cbl/
从表面	cbm/
才不能	cbn/
曹保平	cbp/
擦边球	cbq/
参保人	cbr/
苍白色	cbs/
猜不透	cbt/
曾表示	cbu/
从本质	cbv/
操不完	cbw/
慈悲心	cbx/
曹白鱼	cby/
错别字	cbz/
残存本	ccb/
呲呲呲	ccc/
粗糙的	ccd/
猜猜分	ccf/
层次感	ccg/
从此后	cch/
猜测出	cci/
曾参加	ccj/
猜猜看	cck/
草丛里	ccl/
从侧面	ccm/
菜菜鸟	ccn/
从磁盘	ccp/
岑村桥	ccq/
草苁蓉	ccr/
层层酥	ccs/
村村通	cct/
从此时	ccu/
草丛中	ccv/
层次性	ccx/
曾参与	ccy/
此操作	ccz/
藏毒案	cda/
粗蛋白	cdb/
曾多次	cdc/
粗大的	cdd/
草底儿	cde/
测定法	cdf/
曾当过	cdg/
粗等号	cdh/
从单纯	cdi/
磁带机	cdj/
存贷款	cdk/
菜单栏	cdl/
猜灯谜	cdm/
曾大闹	cdn/
参得破	cdp/
从短期	cdq/
曾担任	cdr/
蚕豆酥	cds/
菜单条	cdt/
裁定书	cdu/
菜单中	cdv/
测定为	cdw/
菜单项	cdx/
才得以	cdy/
菜墩子	cdz/
刺儿菜	cec/
苍儿会	ceh/
雌二醇	cei/
曹娥江	cej/
蔡锷路	cel/
曹恩齐	ceq/
慈恩寺	ces/
刺儿头	cet/
从而使	ceu/
赐恩岩	cey/
苍耳子	cez/
曾发表	cfb/
曹妃甸	cfd/
此方法	cff/
仓房沟	cfg/
蔡枫华	cfh/
存放处	cfi/
才发觉	cfj/
才付款	cfk/
采访了	cfl/
从反面	cfm/
餐费票	cfp/
曹凤岐	cfq/
残废人	cfr/
才放松	cfs/
财付通	cft/
粗放式	cfu/
采访中	cfv/
财富网	cfw/
才发现	cfx/
存放于	cfy/
凑份子	cfz/
采购案	cga/
村干部	cgb/
崔沟村	cgc/
此观点	cgd/
蹿个儿	cge/
财革法	cgf/
从各个	cgg/
采光好	cgh/
曹刚川	cgi/
擦干净	cgj/
从高空	cgk/
参观了	cgl/
曾购买	cgm/
此功能	cgn/
磁光盘	cgp/
参观券	cgq/
茨冈人	cgr/
村公所	cgs/
参观团	cgt/
凑个数	cgu/
参观者	cgv/
采购网	cgw/
菜根香	cgx/
采购员	cgy/
醋罐子	cgz/
策划案	cha/
策划部	chb/
翠亨村	chc/
曾获得	chd/
辞活儿	che/
测绘法	chf/
从宏观	chg/
彩虹海	chh/
从何处	chi/
催化剂	chj/
彩虹裤	chk/
词汇量	chl/
从后面	chm/
粗花呢	chn/
彩虹屁	chp/
彩虹桥	chq/
策划人	chr/
蔡和森	chs/
从合同	cht/
策划师	chu/
策划者	chv/
从后往	chw/
词汇学	chx/
才会有	chy/
才会在	chz/
擦出爱	cia/
苍场村	cic/
蔡崇达	cid/
礤床儿	cie/
仓储费	cif/
采茶工	cig/
擦窗户	cih/
存车处	cii/
才察觉	cij/
存储卡	cik/
存储量	cil/
草场门	cim/
曾承诺	cin/
此产品	cip/
存储器	ciq/
催产素	cis/
从传统	cit/
从床上	ciu/
存储着	civ/
采茶舞	ciw/
采茶戏	cix/
从长远	ciy/
擦窗子	ciz/
曾经爱	cja/
菜煎饼	cjb/
酢浆草	cjc/
刺激的	cjd/
残疾儿	cje/
促进法	cjf/
参加过	cjg/
促进会	cjh/
采金船	cji/
促进剂	cjj/
采集卡	cjk/
参加了	cjl/
曹家庙	cjm/
从今年	cjn/
蔡家坡	cjp/
曾经去	cjq/
残疾人	cjr/
雌激素	cjs/
从今天	cjt/
曾经是	cju/
参加者	cjv/
参加完	cjw/
刺激性	cjx/
曾经有	cjy/
曾经在	cjz/
参考表	ckb/
翠坑村	ckc/
残酷的	ckd/
存款额	cke/
参考法	ckf/
操控杆	ckg/
擦口红	ckh/
才看出	cki/
参考价	ckj/
粲夸克	ckk/
财会类	ckl/
词库名	ckm/
才可能	ckn/
参考品	ckp/
采矿权	ckq/
存款人	ckr/
蔡克嵩	cks/
蹭空调	ckt/
才开始	cku/
词库中	ckv/
财会网	ckw/
参考系	ckx/
才可以	cky/
财会字	ckz/
才来啊	cla/
从来不	clb/
擦了擦	clc/
灿烂的	cld/
侧栏儿	cle/
材料费	clf/
踩了个	clg/
材料后	clh/
材料厂	cli/
从来就	clj/
才离开	clk/
残留量	cll/
从来没	clm/
从了你	cln/
崔立鹏	clp/
沧浪区	clq/
村里人	clr/
翠绿色	cls/
沧浪亭	clt/
策略上	clu/
测量值	clv/
残留物	clw/
材料学	clx/
测量仪	cly/
菜篮子	clz/
才明白	cmb/
错没错	cmc/
聪明的	cmd/
藏闷儿	cme/
粗面粉	cmf/
采蘑菇	cmg/
彩墨画	cmh/
刺毛虫	cmi/
搓麻将	cmj/
侧面看	cmk/
凑满了	cml/
村民们	cmm/
从明年	cmn/
草莓派	cmp/
从目前	cmq/
聪明人	cmr/
侧面图	cmt/
催眠术	cmu/
参谋长	cmv/
草莓味	cmw/
侧面像	cmx/
从没有	cmy/
草莓族	cmz/
才能把	cnb/
才能到	cnd/
从那儿	cne/
采暖费	cnf/
才能够	cng/
彩泥画	cnh/
从年初	cni/
才能进	cnj/
才能看	cnk/
从哪里	cnl/
村农民	cnm/
苍南派	cnp/
采暖期	cnq/
才能让	cnr/
才能使	cnu/
藏匿着	cnv/
才能为	cnw/
苍南县	cnx/
才能有	cny/
藏匿在	cnz/
刺欧鳊	cob/
磁耦合	coh/
从旁边	cpb/
草坪灯	cpd/
脆皮儿	cpe/
菜泡饭	cpf/
擦屁股	cpg/
曾捧红	cph/
脆皮肠	cpi/
磁偏角	cpj/
彩票卡	cpk/
彩牌楼	cpl/
词牌名	cpm/
磁盘片	cpp/
翠屏区	cpq/
才派人	cpr/
裁判所	cps/
裁判团	cpt/
操盘手	cpu/
裁判长	cpv/
彩票网	cpw/
擦皮鞋	cpx/
裁判员	cpy/
菜铺子	cpz/
存取表	cqb/
曾七次	cqc/
采取的	cqd/
凑趣儿	cqe/
催情粉	cqf/
曾去过	cqg/
瓷器活	cqh/
菜青虫	cqi/
从全局	cqj/
此情况	cqk/
采取了	cql/
从前面	cqm/
从去年	cqn/
彩旗飘	cqp/
从前期	cqq/
从前人	cqr/
此其三	cqs/
从其他	cqt/
才起身	cqu/
曾庆祝	cqv/
萃取物	cqw/
措勤县	cqx/
次区域	cqy/
葱肉饼	crb/
草忍村	crc/
脆弱的	crd/
踩热锅	crg/
曾荣获	crh/
藏仁杰	crj/
曹汝霖	crl/
从入门	crm/
凑热闹	crn/
催人跑	crp/
次日起	crq/
催乳素	crs/
存仁堂	crt/
崔润生	cru/
搓揉着	crv/
脆弱性	crx/
才容易	cry/
蔡荣祖	crz/
蚕丝被	csb/
踩酸菜	csc/
参赛队	csd/
参赛费	csf/
草酸钙	csg/
彩色画	csh/
雌三醇	csi/
搓丝机	csj/
参赛卡	csk/
厕所里	csl/
彩色米	csm/
醋酸钠	csn/
彩色片	csp/
测速器	csq/
参赛人	csr/
崔斯特	cst/
才算是	csu/
参赛者	csv/
彩色系	csx/
测速仪	csy/
采桑子	csz/
踩踏板	ctb/
曾吐槽	ctc/
菜太多	ctd/
蔡天凤	ctf/
刺痛感	ctg/
磁头号	cth/
曾提出	cti/
草薙剑	ctj/
彩图库	ctk/
餐厅里	ctl/
操他妈	ctm/
此图片	ctp/
丛台区	ctq/
才通人	ctr/
草堂寺	cts/
曾剃头	ctt/
从天上	ctu/
从图中	ctv/
测体温	ctw/
淬透性	ctx/
从头越	cty/
菜团子	ctz/
藏尸案	cua/
测试版	cub/
草石蚕	cuc/
才使得	cud/
蔡少芬	cuf/
测试过	cug/
测试后	cuh/
菜市场	cui/
从实际	cuj/
菜市口	cuk/
测试类	cul/
丛书名	cum/
曾少年	cun/
此商品	cup/
仓山区	cuq/
词输入	cur/
慈善赛	cus/
测试题	cut/
参事室	cuu/
从书中	cuv/
存水弯	cuw/
从属性	cux/
测试仪	cuy/
财税字	cuz/
财政部	cvb/
崔庄村	cvc/
才知道	cvd/
凑整儿	cve/
粗脂肪	cvf/
挫折感	cvg/
参政会	cvh/
曾指出	cvi/
财政局	cvj/
财智卡	cvk/
从这里	cvl/
从正面	cvm/
藏着呢	cvn/
参展品	cvp/
存贮器	cvq/
村主任	cvr/
财政司	cvs/
此主题	cvt/
参展商	cvu/
从政治	cvv/
参照物	cvw/
财政性	cvx/
侧重于	cvy/
擦桌子	cvz/
财务部	cwb/
曾五次	cwc/
测温度	cwd/
才玩儿	cwe/
蔡文丰	cwf/
从外观	cwg/
村委会	cwh/
财务处	cwi/
刺五加	cwj/
财务科	cwk/
错误率	cwl/
从外面	cwm/
才问你	cwn/
刺猬皮	cwp/
测微器	cwq/
此问题	cwt/
错误时	cwu/
此文章	cwv/
侧卧位	cww/
从外形	cwx/
从未有	cwy/
从未在	cwz/
才心安	cxa/
次谐波	cxb/
磁性瓷	cxc/
从心底	cxd/
从小儿	cxe/
磁悬浮	cxf/
曾写过	cxg/
曾先后	cxh/
曹兴诚	cxi/
从小就	cxj/
蔡小葵	cxk/
曾效力	cxl/
此项目	cxm/
曾许诺	cxn/
促销品	cxp/
曹雪芹	cxq/
参选人	cxr/
操心思	cxs/
从系统	cxt/
慈溪市	cxu/
参选者	cxv/
粗纤维	cxw/
此消息	cxx/
促销员	cxy/
从现在	cxz/
餐饮部	cyb/
猜一猜	cyc/
参与到	cyd/
苍蝇儿	cye/
彩云飞	cyf/
曾有过	cyg/
存银行	cyh/
从远处	cyi/
崔英杰	cyj/
草药课	cyk/
采用了	cyl/
此页面	cym/
崔艺娜	cyn/
蔡元培	cyp/
参与权	cyq/
曾有人	cyr/
慈云寺	cys/
从源头	cyt/
草原上	cyu/
参与者	cyv/
残余物	cyw/
参与性	cyx/
餐饮业	cyy/
菜园子	cyz/
操作表	czb/
才再次	czc/
仓字底	czd/
操作符	czf/
操作工	czg/
草字汇	czh/
从最初	czi/
词作家	czj/
搓澡裤	czk/
村子里	czl/
操作码	czm/
藏在哪	czn/
从早期	czq/
曾赞荣	czr/
操纵索	czs/
操作台	czt/
操作时	czu/
存在着	czv/
错在我	czw/
操作性	czx/
存在于	czy/
从最早	czz/
档案啊	daa/
档案部	dab/
冬奥村	dac/
档案袋	dad/
档案法	daf/
档案馆	dag/
冬奥会	dah/
档案处	dai/
档案局	daj/
档案库	dak/
定安路	dal/
地安门	dam/
戴安娜	dan/
的安排	dap/
大安区	daq/
蛋氨酸	das/
大爱台	dat/
档案室	dau/
答案纸	dav/
冬奥委	daw/
档案学	dax/
档案员	day/
德昂族	daz/
多巴胺	dba/
但并不	dbb/
大白菜	dbc/
得不到	dbd/
打奔儿	dbe/
大部分	dbf/
都不敢	dbg/
都不会	dbh/
代表处	dbi/
到北京	dbj/
打不开	dbk/
大不了	dbl/
蛋白酶	dbm/
都不能	dbn/
大比拼	dbp/
对不起	dbq/
担保人	dbr/
对比赛	dbs/
第八条	dbt/
都不是	dbu/
蛋白质	dbv/
等部位	dbw/
都必须	dbx/
大本营	dby/
代表作	dbz/
多惨啊	dca/
电磁波	dcb/
多层次	dcc/
大辞典	dcd/
对词儿	dce/
电磁阀	dcf/
点测光	dcg/
电催化	dch/
电磁场	dci/
都参加	dcj/
但此刻	dck/
电磁炉	dcl/
多侧面	dcm/
电采暖	dcn/
电磁炮	dcp/
叠彩区	dcq/
稻草人	dcr/
大慈寺	dcs/
电磁铁	dct/
对此事	dcu/
独裁者	dcv/
段错误	dcw/
电磁学	dcx/
都采用	dcy/
躲藏在	dcz/
对答案	dda/
党代表	ddb/
大毒草	ddc/
淡淡的	ddd/
道道儿	dde/
兜底翻	ddf/
道德观	ddg/
打电话	ddh/
电动车	ddi/
电动机	ddj/
地对空	ddk/
得到了	ddl/
大动脉	ddm/
等到你	ddn/
低电平	ddp/
迭代器	ddq/
当地人	ddr/
打哆嗦	dds/
点点头	ddt/
大多数	ddu/
等待着	ddv/
等等我	ddw/
等多项	ddx/
但对于	ddy/
督导组	ddz/
第二版	deb/
第二次	dec/
第二大	ded/
德尔福	def/
第二个	deg/
第二行	deh/
第二场	dei/
第二节	dej/
第二款	dek/
第二轮	del/
第二名	dem/
第二年	den/
第二批	dep/
第二期	deq/
第二日	der/
丁二酸	des/
第二天	det/
第二十	deu/
第二章	dev/
第二位	dew/
第二项	dex/
第二页	dey/
大儿子	dez/
定方案	dfa/
多发病	dfb/
地方菜	dfc/
大幅度	dfd/
得分儿	dfe/
地方法	dff/
豆腐干	dfg/
大富豪	dfh/
得非常	dfi/
豆腐浆	dfj/
大方块	dfk/
东风路	dfl/
等方面	dfm/
豆腐脑	dfn/
豆腐皮	dfp/
担负起	dfq/
东方人	dfr/
大放送	dfs/
地方台	dft/
大丰收	dfu/
大发展	dfv/
大范围	dfw/
地方性	dfx/
豆腐衣	dfy/
大房子	dfz/
多贵啊	dga/
对干部	dgb/
定冠词	dgc/
大股东	dgd/
打嗝儿	dge/
大锅饭	dgf/
大哥哥	dgg/
低功耗	dgh/
胆固醇	dgi/
对国家	dgj/
大公开	dgk/
多公里	dgl/
大规模	dgm/
多功能	dgn/
多个品	dgp/
道过歉	dgq/
德国人	dgr/
大公司	dgs/
带给他	dgt/
东莞市	dgu/
打工者	dgv/
党工委	dgw/
灯光下	dgx/
大概有	dgy/
大概在	dgz/
多好啊	dha/
电话簿	dhb/
大河村	dhc/
都获得	dhd/
大伙儿	dhe/
电话费	dhf/
都会给	dhg/
都很好	dhh/
大红肠	dhi/
电话机	dhj/
对话框	dhk/
电话里	dhl/
都还没	dhm/
地黄牛	dhn/
等会哦	dho/
动画片	dhp/
都会去	dhq/
定会让	dhr/
淡黄色	dhs/
大会堂	dht/
但还是	dhu/
打寒战	dhv/
电话网	dhw/
电话线	dhx/
导航仪	dhy/
带孩子	dhz/
大肠癌	dia/
低成本	dib/
断肠草	dic/
到处都	did/
打岔儿	die/
电吹风	dif/
地产股	dig/
调查和	dih/
到长城	dii/
大肠菌	dij/
多窗口	dik/
洞察力	dil/
大场面	dim/
丁丑年	din/
打差评	dip/
东城区	diq/
调查人	dir/
大赤色	dis/
电唱头	dit/
大城市	diu/
大潮中	div/
都成为	diw/
都出现	dix/
调查员	diy/
调查组	diz/
大劫案	dja/
登记表	djb/
度假村	djc/
大家都	djd/
搭脚儿	dje/
等级分	djf/
都经过	djg/
大家好	djh/
大检查	dji/
第九届	djj/
登记卡	djk/
点击率	djl/
大橘猫	djm/
等几年	djn/
登机牌	djp/
度假区	djq/
登记日	djr/
大奖赛	djs/
第九条	djt/
点击数	dju/
第九章	djv/
低价位	djw/
都进行	djx/
都具有	djy/
大家族	djz/
多可爱	dka/
地矿部	dkb/
大堀彩	dkc/
大跨度	dkd/
道坎儿	dke/
大开发	dkf/
贷款给	dkg/
大客户	dkh/
大客车	dki/
大口径	dkj/
大口框	dkk/
打开了	dkl/
打开门	dkm/
都可能	dkn/
雕刻品	dkp/
读卡器	dkq/
贷款人	dkr/
对抗赛	dks/
对空台	dkt/
都开始	dku/
对抗中	dkv/
当空舞	dkw/
但可惜	dkx/
都可以	dky/
大口子	dkz/
妲丽安	dla/
丢了吧	dlb/
第六次	dlc/
多伦多	dld/
到了儿	dle/
代理费	dlf/
打了个	dlg/
蝶恋花	dlh/
代理处	dli/
第六届	dlj/
德鲁克	dlk/
带来了	dll/
丢了吗	dlm/
第六年	dln/
第六篇	dlp/
断路器	dlq/
代理人	dlr/
淡蓝色	dls/
第六条	dlt/
代理商	dlu/
第六章	dlv/
第六位	dlw/
带领下	dlx/
独立于	dly/
等离子	dlz/
大棉袄	dma/
代码表	dmb/
代名词	dmc/
代码段	dmd/
大面儿	dme/
捣麻烦	dmf/
对美国	dmg/
大明湖	dmh/
大卖场	dmi/
大面积	dmj/
代码块	dmk/
都买了	dml/
独苗苗	dmm/
大美女	dmn/
德米欧	dmo/
动漫片	dmp/
但目前	dmq/
大美人	dmr/
道明寺	dms/
多媒体	dmt/
地面上	dmu/
大拇指	dmv/
定名为	dmw/
大明星	dmx/
都没有	dmy/
多民族	dmz/
胆囊癌	dna/
东南部	dnb/
堆内存	dnc/
当年度	dnd/
丹尼尔	dne/
东南方	dnf/
都能够	dng/
多年后	dnh/
电脑城	dni/
低年级	dnj/
都能看	dnk/
多年来	dnl/
大南门	dnm/
大奶奶	dnn/
带你跑	dnp/
多年前	dnq/
等内容	dnr/
丹尼斯	dns/
大难题	dnt/
对你说	dnu/
电脑桌	dnv/
党内外	dnw/
对那些	dnx/
东南亚	dny/
当你在	dnz/
对偶饿	doe/
单偶婚	doh/
对偶句	doj/
大欧派	dop/
淡耦丝	dos/
对偶图	dot/
对偶性	dox/
兑欧元	doy/
毒品案	dpa/
大瀑布	dpb/
大棚菜	dpc/
多普达	dpd/
大片儿	dpe/
大篇幅	dpf/
大排骨	dpg/
大排行	dph/
电瓶车	dpi/
单片机	dpj/
打扑克	dpk/
打破了	dpl/
大屏幕	dpm/
戴佩妮	dpn/
大品牌	dpp/
东坡区	dpq/
东坡肉	dpr/
大派送	dps/
打喷嚏	dpt/
得票数	dpu/
低品质	dpv/
肚皮舞	dpw/
地平线	dpx/
大平原	dpy/
倒牌子	dpz/
盗窃案	dqa/
第七步	dqb/
第七次	dqc/
多渠道	dqd/
捯气儿	dqe/
但缺乏	dqf/
第七个	dqg/
电气化	dqh/
电器厂	dqi/
第七届	dqj/
等情况	dqk/
动起来	dql/
多千米	dqm/
短期内	dqn/
第七篇	dqp/
打圈圈	dqq/
到期日	dqr/
道琼斯	dqs/
第七条	dqt/
地球上	dqu/
第七张	dqv/
第七位	dqw/
地区性	dqx/
大企业	dqy/
盗窃罪	dqz/
丢人啊	dra/
电热杯	drb/
多人次	drc/
敌人的	drd/
德容恩	dre/
单人房	drf/
代入感	drg/
当然会	drh/
单人床	dri/
单人间	drj/
德瑞克	drk/
大容量	drl/
对人民	drm/
打扰你	drn/
单人旁	drp/
电容器	drq/
但仍然	drr/
电热丝	drs/
电热毯	drt/
当然是	dru/
独任制	drv/
都认为	drw/
得人心	drx/
当然有	dry/
当然在	drz/
多损啊	dsa/
第三步	dsb/
第三次	dsc/
第三代	dsd/
黛丝恩	dse/
第三方	dsf/
第三个	dsg/
电算化	dsh/
大扫除	dsi/
第三节	dsj/
第三款	dsk/
第三类	dsl/
第三名	dsm/
第三年	dsn/
第三批	dsp/
第三期	dsq/
第三人	dsr/
大蒜素	dss/
第三条	dst/
第三十	dsu/
第三章	dsv/
第三位	dsw/
第三项	dsx/
对所有	dsy/
第三组	dsz/
到泰安	dta/
大踏步	dtb/
地图册	dtc/
动态的	dtd/
打挺儿	dte/
掉头发	dtf/
都提供	dtg/
洞庭湖	dth/
都推出	dti/
大团结	dtj/
答题卡	dtk/
大统路	dtl/
对它们	dtm/
电梯内	dtn/
代替品	dtp/
大提琴	dtq/
带头人	dtr/
大提速	dts/
大头贴	dtt/
但同时	dtu/
地铁站	dtv/
对台湾	dtw/
独特性	dtx/
等同于	dty/
搭梯子	dtz/
多少啊	dua/
都市报	dub/
多少次	duc/
但是当	dud/
第十二	due/
得十分	duf/
大使馆	dug/
董事会	duh/
大市场	dui/
电视剧	duj/
电视卡	duk/
诞生了	dul/
大师们	dum/
但是你	dun/
低水平	dup/
多少钱	duq/
当事人	dur/
第十三	dus/
电视台	dut/
多数是	duu/
董事长	duv/
对事物	duw/
都是些	dux/
但是有	duy/
但是在	duz/
堵住啊	dva/
党支部	dvb/
但这次	dvc/
都知道	dvd/
到这儿	dve/
大丈夫	dvf/
对中国	dvg/
党指挥	dvh/
都支持	dvi/
地震局	dvj/
打折扣	dvk/
到这里	dvl/
都这么	dvm/
等着你	dvn/
豆制品	dvp/
读者群	dvq/
对中日	dvr/
大昭寺	dvs/
低着头	dvt/
都只是	dvu/
等症状	dvv/
动植物	dvw/
大中小	dvx/
党中央	dvy/
对照组	dvz/
打我啊	dwa/
第五步	dwb/
第五次	dwc/
第五代	dwd/
爹味儿	dwe/
都无法	dwf/
对我国	dwg/
带问号	dwh/
电位差	dwi/
第五届	dwj/
第五款	dwk/
但无论	dwl/
当我们	dwm/
第五年	dwn/
第五篇	dwp/
定位器	dwq/
低污染	dwr/
戴维斯	dws/
第五条	dwt/
对我说	dwu/
第五章	dwv/
第五位	dww/
但我想	dwx/
动物园	dwy/
定位在	dwz/
东西啊	dxa/
大小便	dxb/
灯芯草	dxc/
典型的	dxd/
店小二	dxe/
东西方	dxf/
大峡谷	dxg/
都喜欢	dxh/
多线程	dxi/
大小姐	dxj/
多学科	dxk/
打下了	dxl/
大熊猫	dxm/
大西南	dxn/
东西欧	dxo/
邓小平	dxp/
大兴区	dxq/
对新人	dxr/
大橡塑	dxs/
低下头	dxt/
大学生	dxu/
对象中	dxv/
都希望	dxw/
短消息	dxx/
都需要	dxy/
到现在	dxz/
第一案	dya/
第一步	dyb/
第一次	dyc/
多余的	dyd/
打佯儿	dye/
大药房	dyf/
第一个	dyg/
多元化	dyh/
第一场	dyi/
打印机	dyj/
第一款	dyk/
答应了	dyl/
第一名	dym/
第一年	dyn/
多云偶	dyo/
第一批	dyp/
第一期	dyq/
代言人	dyr/
的意思	dys/
第一条	dyt/
大约是	dyu/
第一章	dyv/
第一位	dyw/
多样性	dyx/
但由于	dyy/
大约在	dyz/
打字啊	dza/
电子版	dzb/
但自从	dzc/
但遭到	dzd/
打杂儿	dze/
单组分	dzf/
电子管	dzg/
到最后	dzh/
打造成	dzi/
打字机	dzj/
丁字裤	dzk/
肚子里	dzl/
弟子们	dzm/
等在内	dzn/
大嘴鸥	dzo/
动作片	dzp/
电子琴	dzq/
大自然	dzr/
淡紫色	dzs/
但总体	dzt/
电子书	dzu/
党组织	dzv/
电子网	dzw/
电子学	dzx/
等字样	dzy/
独自走	dzz/
二阿姨	eay/
二苯胺	eba/
而不必	ebb/
二倍的	ebd/
饿不饿	ebe/
而并非	ebf/
二百个	ebg/
而不会	ebh/
二苯基	ebj/
二百块	ebk/
二比零	ebl/
二苯醚	ebm/
而不能	ebn/
二部曲	ebq/
二百人	ebr/
饿不死	ebs/
二倍体	ebt/
而不是	ebu/
而不只	ebv/
二百五	ebw/
而不需	ebx/
二百元	eby/
鹅鼻嘴	ebz/
而此次	ecc/
厄崔迪	ecd/
二次方	ecf/
二次根	ecg/
二菜场	eci/
而此刻	eck/
二次曲	ecq/
二次图	ect/
而此时	ecu/
恩赐者	ecv/
二次型	ecx/
二次元	ecy/
二等兵	edb/
二等舱	edc/
嗯对对	edd/
摁钉儿	ede/
二等分	edf/
二等功	edg/
饿得慌	edh/
二等车	edi/
二等奖	edj/
饿得快	edk/
耳朵里	edl/
而得名	edm/
而等你	edn/
耳刀旁	edp/
二道区	edq/
耳朵软	edr/
二段跳	edt/
尔东升	edu/
而斗争	edv/
二大王	edw/
二段线	edx/
而对于	edy/
饿肚子	edz/
二二八	eeb/
鹅鹅鹅	eee/
额尔金	eej/
饿饿年	een/
鄂尔奇	eeq/
鄂尔泰	eet/
鹅鹅杀	eeu/
二𫫇烷	eew/
二𫫇英	eey/
二儿子	eez/
而分别	efb/
而奋斗	efd/
恩菲尔	efe/
二分法	eff/
二分场	efi/
二纺机	efj/
而发狂	efk/
二分类	efl/
二伏面	efm/
阿房女	efn/
二府坪	efp/
二分图	eft/
二妃山	efu/
二分钟	efv/
恩氟烷	efw/
二分校	efx/
鹅凤营	efy/
恶搞版	egb/
鹅公村	egc/
恶鬼道	egd/
恩格尔	ege/
二宫光	egg/
俄国话	egh/
二甘醇	egi/
鹅肝酱	egj/
二个孔	egk/
恩格勒	egl/
恶鬼们	egm/
而国内	egn/
鹅肝坯	egp/
二工区	egq/
俄国人	egr/
恩格斯	egs/
二锅头	egt/
鹅管石	egu/
而告终	egv/
而高兴	egx/
二个月	egy/
二公子	egz/
而轰动	ehd/
俄亥俄	ehe/
恶狠狠	ehh/
二号机	ehj/
耳环孔	ehk/
而忽略	ehl/
二化螟	ehm/
二胡曲	ehq/
鹅黄肉	ehr/
鹅黄色	ehs/
二婚头	eht/
而忽视	ehu/
而后者	ehv/
二环外	ehw/
二号线	ehx/
二合一	ehy/
二皇子	ehz/
二程祠	eic/
二叉堆	eid/
儿茶酚	eif/
二重根	eig/
二重唱	eii/
恩仇记	eij/
恩仇录	eil/
而出名	eim/
鄂城区	eiq/
儿茶素	eis/
二重天	eit/
而产生	eiu/
恩城镇	eiv/
恶臭味	eiw/
而出现	eix/
二串一	eiy/
二重奏	eiz/
二甲胺	eja/
二甲苯	ejb/
二甲村	ejc/
二季度	ejd/
阿胶粉	ejf/
二极管	ejg/
二句话	ejh/
耳机厂	eji/
二甲基	ejj/
阿胶块	ejk/
饿极了	ejl/
二甲醚	ejm/
额济纳	ejn/
阿胶片	ejp/
颚巨人	ejr/
二聚体	ejt/
而减少	eju/
二进制	ejv/
二级网	ejw/
耳机线	ejx/
二级域	ejy/
而就在	ejz/
摁扣儿	eke/
二课分	ekf/
摁开关	ekg/
俄喀河	ekh/
鹅口疮	eki/
恩昆库	ekk/
蒽醌类	ekl/
而苦恼	ekn/
而哭泣	ekq/
而克制	ekv/
儿科学	ekx/
二氯胺	ela/
俄联邦	elb/
遏蓝菜	elc/
耳聋的	eld/
而立法	elf/
俄勒冈	elg/
二里河	elh/
鄂伦春	eli/
二硫键	elj/
厄利空	elk/
饿了龙	ell/
二郎庙	elm/
耳流脓	eln/
二老婆	elp/
扼流圈	elq/
二两肉	elr/
俄罗斯	els/
二郎腿	elt/
鹅卵石	elu/
二里庄	elv/
二郎丸	elw/
恶劣性	elx/
而另一	ely/
二流子	elz/
鹅毛般	emb/
恶魔党	emd/
恶名儿	eme/
二妹夫	emf/
恶魔果	emg/
恶魔化	emh/
恶魔城	emi/
二面角	emj/
蛾蠓科	emk/
二马路	eml/
恶魔们	emm/
恶魔女	emn/
峨眉派	emp/
而目前	emq/
恶魔人	emr/
二妙散	ems/
俄木塘	emt/
峨眉山	emu/
二拇指	emv/
恶魔王	emw/
恶魔系	emx/
蛾眉月	emy/
恶魔族	emz/
二娘啊	ena/
二难并	enb/
二女儿	ene/
而那个	eng/
二年级	enj/
二南开	enk/
而努力	enl/
儿女们	enm/
而你却	enq/
恶女人	enr/
二年生	enu/
二年制	env/
而那些	enx/
二娘子	enz/
二批次	epc/
耳旁风	epf/
阿房宫	epg/
二撇胡	eph/
二皮脸	epl/
恶婆娘	epn/
恶婆婆	epp/
厄普森	eps/
恩平市	epu/
恶评者	epv/
恩平县	epx/
二氢铵	eqa/
而且不	eqb/
而憔悴	eqc/
而且都	eqd/
二缺二	eqe/
二千个	eqg/
而且会	eqh/
二驱车	eqi/
二羟基	eqj/
二千块	eqk/
二七路	eql/
而且能	eqn/
而恰恰	eqq/
二千人	eqr/
二千岁	eqs/
而其他	eqt/
而且是	equ/
二千万	eqw/
而且有	eqy/
而且在	eqz/
鹅绒被	erb/
二人份	erf/
恶人谷	erg/
峨蕊茶	eri/
而如今	erj/
鹅绒裤	erk/
恶人们	erm/
恩瑞斯	ers/
鹅肉汤	ert/
二人转	erv/
二人行	erx/
二日游	ery/
二人组	erz/
二三百	esb/
二三次	esc/
二三个	esg/
二色红	esh/
二三成	esi/
二三件	esj/
饿死了	esl/
二三年	esn/
饿死人	esr/
二羧酸	ess/
恩斯特	est/
二三十	esu/
而随着	esv/
而死亡	esw/
二色性	esx/
二三月	esy/
二三子	esz/
儿童部	etb/
儿童村	etc/
二堂弟	etd/
恩桃儿	ete/
儿童房	etf/
而提供	etg/
儿童画	eth/
儿童床	eti/
儿童节	etj/
而痛苦	etk/
儿童类	etl/
儿童们	etm/
儿童票	etp/
而同期	etq/
二堂嫂	ets/
儿童团	ett/
额头上	etu/
儿童周	etv/
儿童学	etx/
儿童院	ety/
而逃走	etz/
而是把	eub/
而生存	euc/
二十多	eud/
二十二	eue/
二手房	euf/
二十个	eug/
二手货	euh/
二手车	eui/
二十九	euj/
二十块	euk/
二十六	eul/
二十秒	eum/
二十年	eun/
二十篇	eup/
二十七	euq/
二十日	eur/
二十四	eus/
而是他	eut/
而是说	euu/
而是指	euv/
二十五	euw/
峨山县	eux/
二是要	euy/
二十字	euz/
饿着吧	evb/
而这次	evc/
二中队	evd/
鹅掌风	evf/
二掌柜	evg/
二战后	evh/
而著称	evi/
二者间	evj/
饿着了	evl/
而著名	evm/
饿着呢	evn/
鹅掌楸	evq/
尔朱荣	evr/
鹅掌坦	evt/
鄂州市	evu/
二战中	evv/
摁着我	evw/
而这些	evx/
二中院	evy/
耳坠子	evz/
二维表	ewb/
二维的	ewd/
二万个	ewg/
二位好	ewh/
鄂温克	ewk/
而为了	ewl/
而我们	ewm/
二五耦	ewo/
而我却	ewq/
二万人	ewr/
二维图	ewt/
二位数	ewu/
俄外长	ewv/
二万五	eww/
而无需	ewx/
二万元	ewy/
耳捂子	ewz/
恶心啊	exa/
鄂西北	exb/
恶心的	exd/
恩希尔	exe/
儿媳妇	exf/
恶心感	exg/
恶循环	exh/
而形成	exi/
二星级	exj/
而羞愧	exk/
恶心了	exl/
二校门	exm/
恶性疟	exn/
二仙桥	exq/
恶心人	exr/
恶心死	exs/
恶心吐	ext/
俄新社	exu/
而行之	exv/
俄新网	exw/
二芯线	exx/
二选一	exy/
而现在	exz/
二乙胺	eya/
耳语般	eyb/
而与此	eyc/
而一旦	eyd/
二月二	eye/
二月份	eyf/
耳咽管	eyg/
二元化	eyh/
二元醇	eyi/
二乙基	eyj/
而要靠	eyk/
而有力	eyl/
而已嘛	eym/
鳄鱼皮	eyp/
而引起	eyq/
二亿人	eyr/
二元酸	eys/
鹅鸭杀	eyu/
而与之	eyv/
鄂豫皖	eyw/
二义性	eyx/
二医院	eyy/
俄语组	eyz/
儿子般	ezb/
而在此	ezc/
儿子的	ezd/
二姊夫	ezf/
而自豪	ezh/
而做出	ezi/
恶作剧	ezj/
恶唑啉	ezl/
而最让	ezr/
恩佐斯	ezs/
俄总统	ezt/
而在这	ezv/
儿子我	ezw/
而在于	ezy/
伏安表	fab/
凤安村	fac/
氟安定	fad/
飞啊飞	faf/
放暗箭	faj/
发案率	fal/
方案名	fam/
费安娜	fan/
妨碍球	faq/
麸胺酸	fas/
福安市	fau/
反安装	fav/
访澳网	faw/
非癌性	fax/
非奥运	fay/
防艾滋	faz/
腐败案	fba/
范冰冰	fbb/
发布词	fbc/
方便的	fbd/
翻本儿	fbe/
发包方	fbf/
分布广	fbg/
发布会	fbh/
分辨出	fbi/
防暴警	fbj/
分不开	fbk/
分辨率	fbl/
方便面	fbm/
非不能	fbn/
放鞭炮	fbp/
分不清	fbq/
发布人	fbr/
福布斯	fbs/
分布图	fbt/
分布式	fbu/
发布者	fbv/
分别为	fbw/
放不下	fbx/
发表于	fby/
分别在	fbz/
法草案	fca/
发慈悲	fcb/
分层次	fcc/
犯错的	fcd/
防错法	fcf/
翡翠谷	fcg/
风从虎	fch/
翡翠城	fci/
凡参加	fcj/
发财卡	fck/
发财了	fcl/
发财梦	fcm/
发财票	fcp/
芳村区	fcq/
发错人	fcr/
非彩色	fcs/
翡翠台	fct/
发财树	fcu/
分餐制	fcv/
犯错误	fcw/
服从性	fcx/
服从于	fcy/
贩毒案	fda/
辅导班	fdb/
发大财	fdc/
发达的	fdd/
发点儿	fde/
辅导费	fdf/
梵蒂冈	fdg/
负电荷	fdh/
房地产	fdi/
发动机	fdj/
辅导课	fdk/
发动了	fdl/
防盗门	fdm/
斐迪南	fdn/
反对派	fdp/
放大器	fdq/
房大人	fdr/
防盗锁	fds/
反堕胎	fdt/
浮点数	fdu/
反对者	fdv/
防盗网	fdw/
发短信	fdx/
辅导员	fdy/
负电子	fdz/
菲尔波	feb/
份儿菜	fec/
菲尔德	fed/
份儿饭	fef/
伏尔甘	feg/
反而会	feh/
风儿吹	fei/
伏尔加	fej/
法尔考	fek/
费尔马	fem/
凡尔纳	fen/
份儿钱	feq/
粉蛾绒	fer/
凡尔赛	fes/
伏尔泰	fet/
反而是	feu/
发儿小	fex/
非恶意	fey/
反而在	fez/
枫芙爱	ffa/
反腐败	ffb/
丰富村	ffc/
非法定	ffd/
法夫尔	ffe/
风风风	fff/
饭麸果	ffg/
凡符合	ffh/
防腐剂	ffj/
负反馈	ffk/
方法论	ffl/
方法名	ffm/
福法纳	ffn/
方法区	ffq/
非法人	ffr/
方法三	ffs/
扶芳藤	fft/
方法是	ffu/
放风筝	ffv/
方法五	ffw/
非法性	ffx/
副反应	ffy/
反复做	ffz/
赴港澳	fga/
反光板	fgb/
覆盖层	fgc/
法国队	fgd/
复共轭	fge/
分隔符	fgf/
发广告	fgg/
风格化	fgh/
分割成	fgi/
房管局	fgj/
非公开	fgk/
反过来	fgl/
覆盖面	fgm/
发给你	fgn/
风光片	fgp/
飞过去	fgq/
法国人	fgr/
分公司	fgs/
发光体	fgt/
发高烧	fgu/
覆盖着	fgv/
发改委	fgw/
分割线	fgx/
非国有	fgy/
发工资	fgz/
氟化氨	fha/
非货币	fhb/
返回舱	fhc/
繁华的	fhd/
肥活儿	fhe/
复合肥	fhf/
复合管	fhg/
凤凰花	fhh/
发挥出	fhi/
复活节	fhj/
付好款	fhk/
防护林	fhl/
防火门	fhm/
氟化钠	fhn/
发货票	fhp/
防火墙	fhq/
发货人	fhr/
粉红色	fhs/
烽火台	fht/
凤凰山	fhu/
副会长	fhv/
复合物	fhw/
复合型	fhx/
非会员	fhy/
放火罪	fhz/
福长安	fia/
非常棒	fib/
肺穿刺	fic/
非常大	fid/
非常饿	fie/
风吹拂	fif/
非常贵	fig/
非常好	fih/
非常差	fii/
房产局	fij/
妇产科	fik/
发出了	fil/
阜成门	fim/
非常难	fin/
副产品	fip/
发出去	fiq/
非常热	fir/
帆船赛	fis/
非传统	fit/
方程式	fiu/
非常重	fiv/
房产网	fiw/
扶持下	fix/
芳城园	fiy/
方程组	fiz/
犯贱啊	fja/
方尖碑	fjb/
冯骥才	fjc/
防静电	fjd/
凤姐儿	fje/
附加费	fjf/
放几个	fjg/
肺结核	fjh/
飞机场	fji/
反季节	fjj/
飞机库	fjk/
房间里	fjl/
非居民	fjm/
房间内	fjn/
飞机票	fjp/
风景区	fjq/
发件人	fjr/
附加赛	fjs/
佛教徒	fjt/
福建省	fju/
副局长	fjv/
分解为	fjw/
风景线	fjx/
附件炎	fjy/
粪箕子	fjz/
福康安	fka/
妇科病	fkb/
发刊词	fkc/
疯狂地	fkd/
付款额	fke/
封口费	fkf/
反馈给	fkg/
方括号	fkh/
富康车	fki/
封口机	fkj/
反馈卡	fkk/
翻开了	fkl/
方可梦	fkm/
福克纳	fkn/
防空炮	fkp/
封控区	fkq/
付款人	fkr/
福克斯	fks/
方框图	fkt/
放开手	fku/
副科长	fkv/
发卡网	fkw/
反科学	fkx/
付款用	fky/
方块字	fkz/
氟利昂	fla/
菲律宾	flb/
分两次	flc/
反垄断	fld/
浮礼儿	fle/
福利费	flf/
法轮功	flg/
分类号	flh/
分理处	fli/
福利姬	flj/
弗兰克	flk/
法拉利	fll/
富勒姆	flm/
放了你	fln/
飞利浦	flp/
分离器	flq/
芬兰人	flr/
发牢骚	fls/
服了他	flt/
法律上	flu/
粉连纸	flv/
分裂为	flw/
非理性	flx/
福利院	fly/
负离子	flz/
风门坳	fma/
分米波	fmb/
附面层	fmc/
丰满的	fmd/
父母恩	fme/
放没放	fmf/
父母官	fmg/
粉煤灰	fmh/
分泌出	fmi/
方面军	fmj/
罚没款	fmk/
福美来	fml/
反木马	fmm/
仿玛瑙	fmn/
非卖品	fmp/
父母亲	fmq/
发明人	fmr/
法门寺	fms/
飞毛腿	fmt/
分明是	fmu/
抚摸着	fmv/
分泌物	fmw/
父母心	fmx/
腹膜炎	fmy/
非麻醉	fmz/
疯牛病	fnb/
反纳粹	fnc/
妇女的	fnd/
放那儿	fne/
妇女法	fnf/
放哪个	fng/
非农化	fnh/
丰年虫	fni/
妇女节	fnj/
方脑壳	fnk/
愤怒了	fnl/
妇女们	fnm/
放你那	fnn/
父女情	fnq/
疯女人	fnr/
烦恼丝	fns/
福奈特	fnt/
伏牛山	fnu/
烦恼障	fnv/
放牛娃	fnw/
阜宁县	fnx/
非农业	fny/
仿牛仔	fnz/
霏欧纳	fon/
非偶然	for/
分配表	fpb/
凤坪村	fpc/
扶贫点	fpd/
翻篇儿	fpe/
分配法	fpf/
分配给	fpg/
非平衡	fph/
反爬虫	fpi/
方片九	fpj/
扶贫款	fpk/
方片六	fpl/
复平面	fpm/
肺泡囊	fpn/
范跑跑	fpp/
发脾气	fpq/
发盘人	fpr/
方片三	fps/
非普通	fpt/
方片十	fpu/
肥胖者	fpv/
方片五	fpw/
阜平县	fpx/
方片一	fpy/
覆盆子	fpz/
放弃啊	fqa/
分区表	fqb/
反器材	fqc/
反其道	fqd/
粪球儿	fqe/
富强粉	fqf/
番茄谷	fqg/
风情画	fqh/
分清楚	fqi/
番茄酱	fqj/
方铅矿	fqk/
放弃了	fql/
防撬门	fqm/
腹腔内	fqn/
反犬旁	fqp/
发情期	fqq/
发起人	fqr/
分区赛	fqs/
非其他	fqt/
福清市	fqu/
副区长	fqv/
废弃物	fqw/
反倾销	fqx/
非企业	fqy/
负全责	fqz/
富人榜	frb/
非如此	frc/
法人的	frd/
法瑞尔	fre/
范瑞芳	frf/
法人股	frg/
芙蓉花	frh/
缝纫厂	fri/
缝纫机	frj/
佛瑞克	frk/
发热量	frl/
非人民	frm/
非让你	frn/
腐乳瓶	frp/
芙蓉区	frq/
腐乳肉	frr/
风入松	frs/
芙蓉汤	frt/
芙蓉石	fru/
芙蓉镇	frv/
非让我	frw/
发如雪	frx/
疯人院	fry/
非人哉	frz/
放肆爱	fsa/
分三步	fsb/
富色彩	fsc/
发送到	fsd/
粉丝发	fsf/
发送给	fsg/
分散化	fsh/
付思超	fsi/
粉碎机	fsj/
放松了	fsl/
粉丝们	fsm/
傅斯年	fsn/
分散片	fsp/
分赛区	fsq/
发送人	fsr/
非诉讼	fss/
福斯特	fst/
分散式	fsu/
副所长	fsv/
粉丝网	fsw/
分散性	fsx/
风速仪	fsy/
分散在	fsz/
氟他胺	fta/
繁体版	ftb/
繁体词	ftc/
非特定	ftd/
房托儿	fte/
防台风	ftf/
非托管	ftg/
法塔赫	fth/
丰田车	fti/
伏特加	ftj/
反坦克	ftk/
沸腾了	ftl/
仿桃木	ftm/
芬太尼	ftn/
发图片	ftp/
福田区	ftq/
发帖人	ftr/
犯太岁	fts/
发推特	ftt/
发帖数	ftu/
副厅长	ftv/
发推文	ftw/
凤台县	ftx/
沸腾鱼	fty/
发帖子	ftz/
分尸案	fua/
风湿病	fub/
防水层	fuc/
发生的	fud/
发生额	fue/
非师范	fuf/
发生过	fug/
发生后	fuh/
放射出	fui/
副书记	fuj/
富士康	fuk/
发生了	ful/
发什么	fum/
丰收年	fun/
副食品	fup/
发生器	fuq/
发售日	fur/
肺栓塞	fus/
富士通	fut/
佛山市	fuu/
副市长	fuv/
附属物	fuw/
放射性	fux/
发烧友	fuy/
发生在	fuz/
封住啊	fva/
法制办	fvb/
付庄村	fvc/
发展到	fvd/
放这儿	fve/
防治法	fvf/
发展观	fvg/
法制化	fvh/
发展成	fvi/
发展局	fvj/
法制科	fvk/
非主流	fvl/
方志敏	fvm/
烦着呢	fvn/
纺织品	fvp/
发展期	fvq/
副主任	fvr/
腐植酸	fvs/
发纸条	fvt/
福州市	fvu/
发展中	fvv/
发展为	fvw/
副主席	fvx/
纺织业	fvy/
放置在	fvz/
服务部	fwb/
风味餐	fwc/
服务端	fwd/
疯玩儿	fwe/
服务费	fwf/
分五个	fwg/
妇委会	fwh/
俯卧撑	fwi/
蜂王浆	fwj/
服务卡	fwk/
访问量	fwl/
蜂窝煤	fwm/
范围内	fwn/
番外篇	fwp/
服务器	fwq/
防污染	fwr/
服务所	fws/
服务台	fwt/
服务商	fwu/
访问者	fwv/
服务网	fww/
服务型	fwx/
服务业	fwy/
服务组	fwz/
芳香胺	fxa/
放心吧	fxb/
芳香醋	fxc/
发现的	fxd/
发小儿	fxe/
分析法	fxf/
冯小刚	fxg/
分析后	fxh/
分析出	fxi/
方向键	fxj/
复选框	fxk/
发现了	fxl/
复兴门	fxm/
逢小年	fxn/
方向盘	fxp/
反洗钱	fxq/
发行人	fxr/
法西斯	fxs/
分析题	fxt/
分析师	fxu/
副校长	fxv/
飞行物	fxw/
非线性	fxx/
法学院	fxy/
风信子	fxz/
妃悠爱	fya/
风云榜	fyb/
反义词	fyc/
反映的	fyd/
法约尔	fye/
抚养费	fyf/
发言稿	fyg/
放烟花	fyh/
反映出	fyi/
复印件	fyj/
放焰口	fyk/
反映了	fyl/
非移民	fym/
符雅凝	fyn/
非药品	fyp/
发言权	fyq/
发言人	fyr/
法源寺	fys/
菲亚特	fyt/
分以上	fyu/
副院长	fyv/
反应物	fyw/
反应性	fyx/
发源于	fyy/
反映在	fyz/
副总编	fzb/
副总裁	fzc/
复杂度	fzd/
房租费	fzf/
负罪感	fzg/
复杂化	fzh/
风在吹	fzi/
肥皂剧	fzj/
丰子恺	fzk/
房子里	fzl/
夫子庙	fzm/
飞走鸟	fzn/
肥皂泡	fzp/
份子钱	fzq/
负责人	fzr/
非阻塞	fzs/
副总统	fzt/
分子式	fzu/
副组长	fzv/
分组网	fzw/
复杂性	fzx/
副作用	fzy/
发粽子	fzz/
公安部	gab/
国奥村	gac/
国奥队	gad/
公安法	gaf/
郭爱华	gah/
公安处	gai/
公安局	gaj/
谷爱凌	gal/
广安门	gam/
更爱你	gan/
公安派	gap/
更安全	gaq/
谷氨酸	gas/
港澳台	gat/
广安市	gau/
关爱着	gav/
固安县	gax/
港澳游	gay/
孤哀子	gaz/
购并案	gba/
根本不	gbb/
广播操	gbc/
怪不得	gbd/
嘎巴儿	gbe/
工本费	gbf/
该不该	gbg/
更不会	gbh/
改编成	gbi/
顾不及	gbj/
贵宾卡	gbk/
改变了	gbl/
各部门	gbm/
更不能	gbn/
盖玻片	gbp/
过不去	gbq/
给别人	gbr/
古波斯	gbs/
广播台	gbt/
跟不上	gbu/
高标准	gbv/
各部委	gbw/
根本性	gbx/
刚毕业	gby/
高拨子	gbz/
公测版	gcb/
高层次	gcc/
观测到	gcd/
构词法	gcf/
刚才跟	gcg/
光催化	gch/
光存储	gci/
刚参加	gcj/
供参考	gck/
搞错了	gcl/
更聪明	gcm/
高彩萍	gcp/
感测器	gcq/
瓜菜仁	gcr/
甘草酸	gcs/
观测台	gct/
高材生	gcu/
观测站	gcv/
共存亡	gcw/
肝藏血	gcx/
观测员	gcy/
刚才在	gcz/
龚道安	gda/
感到不	gdb/
高档次	gdc/
固定的	gdd/
骨朵儿	gde/
给对方	gdf/
郭德纲	gdg/
感到很	gdh/
高档车	gdi/
给大家	gdj/
该地块	gdk/
规定了	gdl/
关帝庙	gdm/
过大年	gdn/
高电平	gdp/
各地区	gdq/
广东人	gdr/
供电所	gds/
滚动条	gdt/
广东省	gdu/
规定者	gdv/
各单位	gdw/
过渡性	gdx/
跟单员	gdy/
光电子	gdz/
个儿矮	gea/
古尔邦	geb/
鼓儿词	gec/
管儿灯	ged/
高尔夫	gef/
隔而固	geg/
肝儿颤	gei/
感恩节	gej/
哥儿俩	gel/
格尔木	gem/
官恩娜	gen/
嗝儿屁	gep/
钙尔奇	geq/
感恩日	ger/
庚二酸	ges/
肱二头	get/
挂耳式	geu/
高二壮	gev/
共轭物	gew/
更恶心	gex/
孤儿院	gey/
干儿子	gez/
该法案	gfa/
更方便	gfb/
寡妇村	gfc/
广泛的	gfd/
顾逢恩	gfe/
更丰富	gff/
功放管	gfg/
规范化	gfh/
郭富城	gfi/
鼓风机	gfj/
购房款	gfk/
辜负了	gfl/
各方面	gfm/
干翻你	gfn/
功夫哦	gfo/
功夫片	gfp/
高峰期	gfq/
贵妇人	gfr/
共发送	gfs/
辜负他	gft/
公费生	gfu/
购房者	gfv/
共分为	gfw/
规范性	gfx/
更富有	gfy/
高分子	gfz/
更贵啊	gga/
广告部	ggb/
广告词	ggc/
古怪的	ggd/
高跟儿	gge/
广告费	ggf/
嘎咕嘎	ggg/
刚刚好	ggh/
观光车	ggi/
更高级	ggj/
更广阔	ggk/
公告栏	ggl/
干革命	ggm/
肝功能	ggn/
广告牌	ggp/
感光器	ggq/
广告人	ggr/
该公司	ggs/
观光团	ggt/
广告商	ggu/
盖公章	ggv/
广告位	ggw/
各高校	ggx/
广告语	ggy/
刚刚在	ggz/
干哈啊	gha/
高回报	ghb/
桂花村	ghc/
更好的	ghd/
干活儿	ghe/
挂号费	ghf/
共和国	ghg/
骨灰盒	ghh/
勾画出	ghi/
规划局	ghj/
更何况	ghk/
更换了	ghl/
辜鸿铭	ghm/
高耗能	ghn/
郭海萍	ghp/
规划区	ghq/
光和热	ghr/
更划算	ghs/
规划图	ght/
供货商	ghu/
高画质	ghv/
规划委	ghw/
挂号信	ghx/
各行业	ghy/
给孩子	ghz/
古长安	gia/
工程部	gib/
各车次	gic/
共产党	gid/
更充分	gif/
该成果	gig/
国产化	gih/
国产车	gii/
歌唱家	gij/
工程款	gik/
构成了	gil/
光触媒	gim/
刚成年	gin/
各产品	gip/
古城墙	giq/
狗吃肉	gir/
更出色	gis/
高产田	git/
工程师	giu/
过程中	giv/
更成为	giw/
工程系	gix/
贯穿于	giy/
广成子	giz/
宫颈癌	gja/
工具包	gjb/
关键词	gjc/
感觉到	gjd/
过劲儿	gje/
国际法	gjf/
钢结构	gjg/
国际化	gjh/
公交车	gji/
国家级	gjj/
甘家口	gjk/
工具栏	gjl/
郭敬明	gjm/
高技能	gjn/
巩金瓯	gjo/
管家婆	gjp/
更精确	gjq/
刚进入	gjr/
冠军赛	gjs/
工具条	gjt/
关键是	gju/
攻击者	gjv/
归结为	gjw/
国际性	gjx/
更具有	gjy/
关键字	gjz/
更可爱	gka/
赶快把	gkb/
高空槽	gkc/
更快地	gkd/
谷壳儿	gke/
各开发	gkf/
更可贵	gkg/
给客户	gkh/
改款车	gki/
高科技	gkj/
公开课	gkk/
概括了	gkl/
敢抗命	gkm/
更可能	gkn/
更可怕	gkp/
赶快去	gkq/
公开赛	gks/
该课题	gkt/
刚开始	gku/
更看重	gkv/
工控网	gkw/
更科学	gkx/
更可以	gky/
赶快走	gkz/
过来啊	gla/
管理部	glb/
管理层	glc/
高亮度	gld/
狗链儿	gle/
管理费	glf/
龟苓膏	glg/
更厉害	glh/
管理处	gli/
管理局	glj/
管理科	glk/
管理类	gll/
古罗马	glm/
给了你	gln/
关了哦	glo/
格鲁派	glp/
过滤器	glq/
管理人	glr/
管理所	gls/
给了他	glt/
管理上	glu/
管理者	glv/
给了我	glw/
管理学	glx/
管理员	gly/
钙离子	glz/
干嘛啊	gma/
搞明白	gmb/
灌木丛	gmc/
国民党	gmd/
哥们儿	gme/
购买方	gmf/
鬼门关	gmg/
规模化	gmh/
改名成	gmi/
购买价	gmj/
观摩课	gmk/
购买了	gml/
歌迷们	gmm/
干嘛呢	gmn/
古墓派	gmp/
高明区	gmq/
郭沫若	gmr/
戈麦斯	gms/
各媒体	gmt/
过敏史	gmu/
购买者	gmv/
更名为	gmw/
过敏性	gmx/
更没有	gmy/
各民族	gmz/
高尼奥	gna/
功能表	gnb/
狗奴才	gnc/
高难度	gnd/
姑娘儿	gne/
国内法	gnf/
概念股	gng/
高能耗	gnh/
概念车	gni/
功能键	gnj/
给你看	gnk/
过年嘞	gnl/
给你们	gnm/
姑奶奶	gnn/
骨牛排	gnp/
更年期	gnq/
给女人	gnr/
给你扫	gns/
给你听	gnt/
功能上	gnu/
观念中	gnv/
国内外	gnw/
功能性	gnx/
工农业	gny/
该男子	gnz/
古偶剧	goj/
盖欧卡	gok/
个屁阿	gpa/
光盘版	gpb/
高频词	gpc/
供配电	gpd/
歌片儿	gpe/
光谱法	gpf/
光屁股	gpg/
搞破坏	gph/
跟屁虫	gpi/
挂牌价	gpj/
高普考	gpk/
更漂亮	gpl/
瓜皮帽	gpm/
购票难	gpn/
更配哦	gpo/
各品牌	gpp/
骨盆腔	gpq/
股票热	gpr/
公平锁	gps/
高频头	gpt/
桂平市	gpu/
高品质	gpv/
高品位	gpw/
公平性	gpx/
给朋友	gpy/
挂牌子	gpz/
高桥爱	gqa/
刚起步	gqb/
高桥村	gqc/
高强度	gqd/
贵圈儿	gqe/
过桥费	gqf/
各器官	gqg/
古气候	gqh/
搞清楚	gqi/
国庆节	gqj/
钢琴课	gqk/
过去了	gql/
歌曲名	gqm/
跟去年	gqn/
钢琴谱	gqp/
钢琴曲	gqq/
国庆日	gqr/
更轻松	gqs/
共青团	gqt/
感情上	gqu/
光圈值	gqv/
供求网	gqw/
高清晰	gqx/
该企业	gqy/
枸杞子	gqz/
果然啊	gra/
个人版	grb/
隔热层	grc/
公认的	grd/
果仁儿	gre/
干热风	grf/
光荣感	grg/
该如何	grh/
干扰车	gri/
该软件	grj/
甘荣坤	grk/
感染力	grl/
工人们	grm/
该让你	grn/
光荣牌	grp/
干扰器	grq/
更让人	grr/
干扰素	grs/
该让他	grt/
果然是	gru/
感染者	grv/
公认为	grw/
感染性	grx/
更容易	gry/
过日子	grz/
该死啊	gsa/
姑嫂饼	gsb/
高斯磁	gsc/
高速度	gsd/
格萨尔	gse/
公司法	gsf/
高速钢	gsg/
公司化	gsh/
姑苏城	gsi/
公司间	gsj/
哥萨克	gsk/
公司里	gsl/
光扫描	gsm/
告诉你	gsn/
高送配	gsp/
各赛区	gsq/
公诉人	gsr/
戈森斯	gss/
告诉他	gst/
甘肃省	gsu/
高素质	gsv/
告诉我	gsw/
姑苏行	gsx/
硅酸盐	gsy/
公孙瓒	gsz/
割头案	gta/
国台办	gtb/
感叹词	gtc/
共同点	gtd/
跟趟儿	gte/
过堂风	gtf/
蓇葖果	gtg/
个体户	gth/
钢铁厂	gti/
国土局	gtj/
更痛苦	gtk/
光通量	gtl/
给他们	gtm/
管他呢	gtn/
罐头瓶	gtp/
柜台前	gtq/
高投入	gtr/
古铜色	gts/
共同体	gtt/
跟他说	gtu/
该同志	gtv/
宫廷舞	gtw/
光通信	gtx/
钢铁业	gty/
赶他走	gtz/
干啥啊	gua/
故事吧	gub/
更深层	guc/
感受到	gud/
管事儿	gue/
国税发	guf/
归属感	gug/
格式化	guh/
过山车	gui/
工商局	guj/
更深刻	guk/
工商联	gul/
干什么	gum/
干啥呢	gun/
高水平	gup/
灌水区	guq/
过生日	gur/
工商所	gus/
赶上趟	gut/
各省市	guu/
感受着	guv/
古生物	guw/
观赏性	gux/
工商业	guy/
高山族	guz/
跟着爱	gva/
各支部	gvb/
骨质瓷	gvc/
公正的	gvd/
高招儿	gve/
高脂肪	gvf/
更直观	gvg/
改制后	gvh/
公证处	gvi/
更直接	gvj/
高真空	gvk/
高质量	gvl/
故障码	gvm/
各职能	gvn/
古装片	gvp/
更准确	gvq/
广州人	gvr/
观众赛	gvs/
跟着他	gvt/
广州市	gvu/
更注重	gvv/
构筑物	gvw/
公正性	gvx/
更重要	gvy/
高中组	gvz/
给我啊	gwa/
公文包	gwb/
公务舱	gwc/
更稳定	gwd/
港味儿	gwe/
更无法	gwf/
给我滚	gwg/
管委会	gwh/
购物车	gwi/
该文件	gwj/
公务卡	gwk/
跟我来	gwl/
给我们	gwm/
过完年	gwn/
歌舞片	gwp/
国务卿	gwq/
高污染	gwr/
睾丸素	gws/
歌舞厅	gwt/
岗位上	gwu/
贵网站	gwv/
购物网	gww/
古文献	gwx/
国务院	gwy/
跟我走	gwz/
高兴啊	gxa/
共享版	gxb/
关系词	gxc/
高效的	gxd/
弓弦儿	gxe/
高消费	gxf/
各相关	gxg/
个性化	gxh/
弓形虫	gxi/
贡献奖	gxj/
各学科	gxk/
古希腊	gxl/
该项目	gxm/
高性能	gxn/
搞笑片	gxp/
感兴趣	gxq/
关系人	gxr/
干休所	gxs/
关系图	gxt/
给学生	gxu/
贡献值	gxv/
更希望	gxw/
更详细	gxx/
更需要	gxy/
供选择	gxz/
更有爱	gya/
工业部	gyb/
关于此	gyc/
关于对	gyd/
沟沿儿	gye/
高压釜	gyf/
国有股	gyg/
工业化	gyh/
工业城	gyi/
公益金	gyj/
感应卡	gyk/
供应链	gyl/
该页面	gym/
公园内	gyn/
工艺品	gyp/
工业区	gyq/
共有人	gyr/
概预算	gys/
过一天	gyt/
供应商	gyu/
公有制	gyv/
广域网	gyw/
公益性	gyx/
工业园	gyy/
赶鸭子	gyz/
工作啊	gza/
工作表	gzb/
甘紫菜	gzc/
各自的	gzd/
瓜子儿	gze/
工作服	gzf/
更糟糕	gzg/
工作后	gzh/
构造出	gzi/
给自己	gzj/
工作狂	gzk/
工作量	gzl/
该怎么	gzm/
格子呢	gzn/
广字旁	gzp/
构造器	gzq/
工作日	gzr/
古紫色	gzs/
工作台	gzt/
工作室	gzu/
工作中	gzv/
国资委	gzw/
工资性	gzx/
工作与	gzy/
工作组	gzz/
昏暗暗	haa/
河岸边	hab/
后安村	hac/
昏暗的	had/
黑暗粉	haf/
很昂贵	hag/
回安徽	hah/
很爱吃	hai/
很安静	haj/
很爱看	hak/
磺胺类	hal/
皇阿玛	ham/
很爱你	han/
海岸炮	hap/
很安全	haq/
好爱他	hat/
淮安市	hau/
还爱着	hav/
很爱玩	haw/
海岸线	hax/
磺胺药	hay/
好笨啊	hba/
黑板报	hbb/
很不错	hbc/
恨不得	hbd/
话把儿	hbe/
好办法	hbf/
还不够	hbg/
会不会	hbh/
合并成	hbi/
环保局	hbj/
还包括	hbk/
回报率	hbl/
伙伴们	hbm/
还不能	hbn/
很棒哦	hbo/
会被喷	hbp/
很抱歉	hbq/
还不如	hbr/
灰白色	hbs/
好半天	hbt/
河北省	hbu/
会爆炸	hbv/
海勃湾	hbw/
还必须	hbx/
汉白玉	hby/
合并在	hbz/
好惨啊	hca/
很粗糙	hcc/
红草地	hcd/
回村儿	hce/
侯彩凤	hcf/
黑磁鼓	hcg/
韩村河	hch/
缓存池	hci/
核裁军	hcj/
很惭愧	hck/
黑材料	hcl/
很聪明	hcm/
好彩年	hcn/
海沧区	hcq/
很脆弱	hcr/
华藏寺	hcs/
好彩头	hct/
喝彩声	hcu/
还藏着	hcv/
慧聪网	hcw/
很慈祥	hcx/
后槽牙	hcy/
还存在	hcz/
很大啊	hda/
很多不	hdb/
很多次	hdc/
皇帝的	hdd/
亨德尔	hde/
好地方	hdf/
很多个	hdg/
活动后	hdh/
火电厂	hdi/
回到家	hdj/
活动课	hdk/
获得了	hdl/
横断面	hdm/
很多年	hdn/
好的哦	hdo/
幻灯片	hdp/
海淀区	hdq/
很多人	hdr/
哈迪斯	hds/
红地毯	hdt/
回答说	hdu/
活动中	hdv/
回答我	hdw/
好东西	hdx/
宏定义	hdy/
坏点子	hdz/
好饿啊	hea/
哈尔滨	heb/
虎耳草	hec/
很二的	hed/
河尔法	hef/
后儿个	heg/
活儿好	heh/
核二厂	hei/
华尔街	hej/
花儿开	hek/
很恶劣	hel/
荷尔蒙	hem/
好儿女	hen/
黄恩茹	her/
鸿恩寺	hes/
赫尔特	het/
孩儿参	heu/
核讹诈	hev/
哈尔温	hew/
很恶心	hex/
耗儿鱼	hey/
华尔兹	hez/
好烦啊	hfa/
很方便	hfb/
糊粉层	hfc/
很发达	hfd/
会费额	hfe/
很丰富	hff/
很反感	hfg/
合法化	hfh/
黄粉虫	hfi/
河坊街	hfj/
后付款	hfk/
恢复了	hfl/
霍夫曼	hfm/
红发男	hfn/
好烦哦	hfo/
护肤品	hfp/
恢复期	hfq/
合肥人	hfr/
护发素	hfs/
海富通	hft/
合肥市	hfu/
寒风中	hfv/
划分为	hfw/
合法性	hfx/
挥发油	hfy/
很复杂	hfz/
黑鬼啊	hga/
会改变	hgb/
或干脆	hgc/
或更多	hgd/
黑格尔	hge/
海关法	hgf/
或更高	hgg/
合格后	hgh/
化工厂	hgi/
很关键	hgj/
合格考	hgk/
合格率	hgl/
患感冒	hgm/
灰姑娘	hgn/
火工品	hgp/
回过去	hgq/
韩国人	hgr/
还告诉	hgs/
回过头	hgt/
花岗石	hgu/
合格证	hgv/
还给我	hgw/
很高兴	hgx/
花岗岩	hgy/
好工作	hgz/
很好啊	hha/
汉化版	hhb/
黄花菜	hhc/
辉煌的	hhd/
红孩儿	hhe/
换行符	hhf/
好好干	hhg/
哈哈哈	hhh/
豪华车	hhi/
黑胡椒	hhj/
很好看	hhk/
后悔了	hhl/
还好吗	hhm/
好怀念	hhn/
好坏哦	hho/
好害怕	hhp/
很好奇	hhq/
合伙人	hhr/
火花塞	hhs/
很好听	hht/
挥挥手	hhu/
呼唤着	hhv/
化合物	hhw/
豪华型	hhx/
还会有	hhy/
好孩子	hhz/
合成氨	hia/
好崇拜	hib/
合成词	hic/
合唱队	hid/
话茬儿	hie/
红茶坊	hif/
很成功	hig/
护城河	hih/
还常常	hii/
好成绩	hij/
黑长裤	hik/
换成了	hil/
很出名	him/
好吹牛	hin/
灰翅鸥	hio/
火车票	hip/
缓冲区	hiq/
海超人	hir/
很出色	his/
合唱团	hit/
火车上	hiu/
火车站	hiv/
会成为	hiw/
会出现	hix/
缓冲液	hiy/
还处在	hiz/
行家啊	hja/
回家吧	hjb/
好几次	hjc/
很简单	hjd/
后劲儿	hje/
胡椒粉	hjf/
好几个	hjg/
回家后	hjh/
还经常	hji/
黄金甲	hjj/
好几棵	hjk/
回家了	hjl/
好久没	hjm/
好几年	hjn/
回家哦	hjo/
火箭炮	hjp/
好价钱	hjq/
和家人	hjr/
婚介所	hjs/
胡锦涛	hjt/
环节上	hju/
黄金周	hjv/
合计为	hjw/
黄健翔	hjx/
或建议	hjy/
还将在	hjz/
很可爱	hka/
户口簿	hkb/
户口册	hkc/
欢快的	hkd/
还款额	hke/
喝咖啡	hkf/
航空港	hkg/
喊口号	hkh/
很宽敞	hki/
灰空间	hkj/
会扣款	hkk/
很快乐	hkl/
好看吗	hkm/
很可能	hkn/
好卡哦	hko/
很可怕	hkp/
航空器	hkq/
汇款人	hkr/
汉克斯	hks/
哈空调	hkt/
海口市	hku/
很看重	hkv/
很可恶	hkw/
很开心	hkx/
还可以	hky/
火筷子	hkz/
哈喽啊	hla/
胡萝卜	hlb/
回龙村	hlc/
合理的	hld/
海拉尔	hle/
护理费	hlf/
回龙观	hlg/
回来后	hlh/
胡兰成	hli/
黑龙江	hlj/
海陆空	hlk/
回来了	hll/
红楼梦	hlm/
火烈鸟	hln/
好累哦	hlo/
黄脸婆	hlp/
湖里区	hlq/
荷兰人	hlr/
黄绿色	hls/
黑龙潭	hlt/
回来时	hlu/
后来者	hlv/
互联网	hlw/
合理性	hlx/
海洛因	hly/
哈喇子	hlz/
好慢啊	hma/
很明白	hmb/
花名册	hmc/
黑名单	hmd/
黑木耳	hme/
很麻烦	hmf/
红玫瑰	hmg/
荒漠化	hmh/
毫米长	hmi/
护目镜	hmj/
汗毛孔	hmk/
花木兰	hml/
和妈妈	hmm/
画眉鸟	hmn/
号码牌	hmp/
豁免权	hmq/
很迷人	hmr/
红霉素	hms/
海绵体	hmt/
号码是	hmu/
昏迷中	hmv/
海明威	hmw/
很明显	hmx/
还没有	hmy/
汉民族	hmz/
还能爱	hna/
换尿布	hnb/
湖南菜	hnc/
海南岛	hnd/
好男儿	hne/
淮南方	hnf/
还能够	hng/
好女孩	hnh/
好难吃	hni/
回娘家	hnj/
很难看	hnk/
海宁路	hnl/
和你们	hnm/
喝牛奶	hnn/
贺年片	hnp/
很年轻	hnq/
好男人	hnr/
哈纳斯	hns/
混凝土	hnt/
河南省	hnu/
还拿着	hnv/
海内外	hnw/
化脓性	hnx/
很难有	hny/
还能在	hnz/
海鸥蛤	hoh/
海鸥街	hoj/
很偶然	hor/
浩耦丝	hos/
很普遍	hpb/
侯佩岑	hpc/
好评度	hpd/
画片儿	hpe/
很佩服	hpf/
红苹果	hpg/
后怕虎	hph/
很平常	hpi/
很平静	hpj/
含鄱口	hpk/
很漂亮	hpl/
海平面	hpm/
害怕你	hpn/
红扑扑	hpp/
和平区	hpq/
海普瑞	hpr/
很怕死	hps/
很普通	hpt/
黄皮书	hpu/
花盆中	hpv/
琥珀屋	hpw/
合浦县	hpx/
好朋友	hpy/
好片子	hpz/
回去啊	hqa/
华强北	hqb/
红旗村	hqc/
好奇的	hqd/
好气儿	hqe/
还缺乏	hqf/
很奇怪	hqg/
回青海	hqh/
很清楚	hqi/
黑旗军	hqj/
还欠款	hqk/
回去了	hql/
花钱买	hqm/
胡青牛	hqn/
沪青平	hqp/
黑漆漆	hqq/
很气人	hqr/
很轻松	hqs/
或其他	hqt/
黄秋生	hqu/
获取值	hqv/
婚庆网	hqw/
好奇心	hqx/
或企业	hqy/
后勤组	hqz/
好热啊	hra/
黄热病	hrb/
还如此	hrc/
华容道	hrd/
烩肉饭	hrf/
胡日鬼	hrg/
黄日华	hrh/
害人虫	hri/
忽然间	hrj/
好人卡	hrk/
核燃料	hrl/
很热门	hrm/
会让你	hrn/
好热哦	hro/
换热器	hrq/
很让人	hrr/
海瑞斯	hrs/
怀仁堂	hrt/
环绕声	hru/
环绕着	hrv/
还认为	hrw/
很荣幸	hrx/
很容易	hry/
好日子	hrz/
好骚啊	hsa/
贺岁版	hsb/
烩酸菜	hsc/
红丝带	hsd/
胡塞尔	hse/
回溯法	hsf/
活塞杆	hsg/
会损害	hsh/
换算成	hsi/
红四军	hsj/
哈萨克	hsk/
黑森林	hsl/
画素描	hsm/
磺酸钠	hsn/
贺岁片	hsp/
黑色旗	hsq/
活死人	hsr/
黑色素	hss/
赫斯特	hst/
还算是	hsu/
会随着	hsv/
黑色物	hsw/
寒酸相	hsx/
侯赛因	hsy/
齁嗓子	hsz/
好听啊	hta/
很特别	htb/
花田错	htc/
荒唐的	htd/
好天儿	hte/
合同法	htf/
还提供	htg/
皇太后	hth/
火腿肠	hti/
皇太极	htj/
回头看	htk/
糊涂了	htl/
还他妈	htm/
惠特尼	htn/
火腿片	htp/
航天器	htq/
核桃仁	htr/
黄体素	hts/
活脱脱	htt/
和同事	htu/
合同制	htv/
回头望	htw/
虎跳峡	htx/
航天员	hty/
或投资	htz/
还爽啊	hua/
还是被	hub/
好身材	huc/
华盛顿	hud/
回事儿	hue/
很舒服	huf/
还是个	hug/
还是很	huh/
海事处	hui/
后视镜	huj/
函数库	huk/
忽视了	hul/
花生米	hum/
还是能	hun/
华山派	hup/
回收期	huq/
还是让	hur/
寒山寺	hus/
函数体	hut/
黄山市	huu/
回收站	huv/
何首乌	huw/
还剩下	hux/
还是有	huy/
还是在	huz/
好重啊	hva/
黄纸板	hvb/
杭州菜	hvc/
活着的	hvd/
花招儿	hve/
好丈夫	hvf/
获中国	hvg/
核准后	hvh/
很正常	hvi/
或直接	hvj/
黄竹坑	hvk/
号召力	hvl/
后缀名	hvm/
还真难	hvn/
化妆品	hvp/
海珠区	hvq/
黄种人	hvr/
红詹森	hvs/
好兆头	hvt/
或者是	hvu/
很执着	hvv/
杭州湾	hvw/
胡主席	hvx/
很重要	hvy/
赫哲族	hvz/
好玩啊	hwa/
红卫兵	hwb/
恒温槽	hwc/
汉武帝	hwd/
好玩儿	hwe/
会务费	hwf/
红外光	hwg/
画问号	hwh/
环卫处	hwi/
护卫舰	hwj/
核武库	hwk/
婚外恋	hwl/
很完美	hwm/
很无奈	hwn/
黄文平	hwp/
核武器	hwq/
后五日	hwr/
化物所	hws/
核问题	hwt/
和我说	hwu/
好文章	hwv/
还问我	hww/
红外线	hwx/
话务员	hwy/
黑屋子	hwz/
河西岸	hxa/
红细胞	hxb/
华西村	hxc/
呼吸道	hxd/
好性儿	hxe/
很幸福	hxf/
和相关	hxg/
很喜欢	hxh/
滑雪场	hxi/
黄小姐	hxj/
很辛苦	hxk/
活下来	hxl/
黄晓明	hxm/
好想你	hxn/
化学品	hxp/
活下去	hxq/
候选人	hxr/
很相似	hxs/
活性炭	hxt/
好像是	hxu/
幻想着	hxv/
很希望	hxw/
好消息	hxx/
还需要	hxy/
好像在	hxz/
还有啊	hya/
喝一杯	hyb/
喝一次	hyc/
活跃度	hyd/
红印儿	hye/
婚姻法	hyf/
还有个	hyg/
很遗憾	hyh/
还原成	hyi/
会员价	hyj/
会员卡	hyk/
怀孕了	hyl/
很有名	hym/
欢迎您	hyn/
黄炎培	hyp/
会引起	hyq/
还有人	hyr/
好意思	hys/
会议厅	hyt/
会议上	hyu/
换言之	hyv/
还以为	hyw/
会影响	hyx/
汉语言	hyy/
合音字	hyz/
孩子啊	hza/
汇总表	hzb/
后再次	hzc/
后自动	hzd/
花籽儿	hze/
合租房	hzf/
鹤嘴镐	hzg/
合作化	hzh/
胡子茬	hzi/
很早就	hzj/
还在看	hzk/
喝醉了	hzl/
孩子们	hzm/
孩子呢	hzn/
红嘴鸥	hzo/
盒子炮	hzp/
孩子气	hzq/
很自然	hzr/
红棕色	hzs/
红枣汤	hzt/
合作社	hzu/
合作者	hzv/
海贼王	hzw/
黄宗羲	hzx/
还在于	hzy/
黄宗泽	hzz/
长安杯	iab/
长安村	iac/
长安道	iad/
纯爱番	iaf/
陈哀公	iag/
长安号	iah/
长安城	iai/
长安街	iaj/
长安客	iak/
长安路	ial/
陈艾湄	iam/
长安宁	ian/
长安牌	iap/
长安区	iaq/
长安人	iar/
陈艾森	ias/
长安塔	iat/
长安市	iau/
宠爱着	iav/
长安网	iaw/
潮安县	iax/
长安夜	iay/
穿袄子	iaz/
吃吧啊	iba/
吃不饱	ibb/
尝百草	ibc/
差不多	ibd/
车本儿	ibe/
承包方	ibf/
传播给	ibg/
车标号	ibh/
查不出	ibi/
出版局	ibj/
储备库	ibk/
储备粮	ibl/
出必买	ibm/
崇拜你	ibn/
长坂坡	ibp/
传播权	ibq/
承包人	ibr/
场比赛	ibs/
崇拜他	ibt/
出版社	ibu/
出版者	ibv/
出版物	ibw/
传播学	ibx/
出版业	iby/
筹备组	ibz/
冲刺班	icb/
唱错词	icc/
查词典	icd/
长词儿	ice/
储存法	icf/
川菜馆	icg/
春菜华	ich/
炒菜铲	ici/
除草剂	icj/
储存卡	ick/
持仓量	icl/
出餐慢	icm/
储藏期	icq/
除草人	icr/
成菜色	ics/
茶餐厅	ict/
纯粹是	icu/
成才者	icv/
尺寸为	icw/
储藏箱	icx/
常采用	icy/
储存在	icz/
查档案	ida/
充电宝	idb/
炒的菜	idc/
彻底的	idd/
差点儿	ide/
臭豆腐	idf/
车道沟	idg/
吃得好	idh/
沉淀池	idi/
超低价	idj/
城垛口	idk/
传达了	idl/
陈道明	idm/
肠道内	idn/
超低频	idp/
充电器	idq/
成都人	idr/
肠毒素	ids/
乘地铁	idt/
成都市	idu/
承担着	idv/
长度为	idw/
吃东西	idx/
重定义	idy/
吹笛子	idz/
长二村	iec/
查尔顿	ied/
虫儿飞	ief/
唱儿歌	ieg/
绰尔河	ieh/
初二级	iej/
炒饵块	iek/
长二米	iem/
车尔尼	ien/
超额配	iep/
超额认	ier/
查尔斯	ies/
长耳兔	iet/
车恩尚	ieu/
长耳坠	iev/
超恶心	iex/
长耳族	iez/
吃饭啊	ifa/
成反比	ifb/
长丰村	ifc/
充分的	ifd/
车份儿	ife/
处罚法	iff/
成分股	ifg/
超负荷	ifh/
春风吹	ifi/
乘飞机	ifj/
出风口	ifk/
出发了	ifl/
厨房门	ifm/
除非你	ifn/
超方瓶	ifp/
出发前	ifq/
吃肥肉	ifr/
崇福寺	ifs/
长方体	ift/
吃饭时	ifu/
重复着	ifv/
超范围	ifw/
长方形	ifx/
处方药	ify/
除非在	ifz/
查个案	iga/
除个别	igb/
炒个菜	igc/
成功的	igd/
插关儿	ige/
吃过饭	igf/
成功感	igg/
常规化	igh/
长谷川	igi/
成果奖	igj/
抽个空	igk/
超过了	igl/
车公庙	igm/
传给你	ign/
炒股票	igp/
传感器	igq/
吃狗肉	igr/
车管所	igs/
超固态	igt/
长葛市	igu/
成功者	igv/
超高温	igw/
陈冠希	igx/
超高压	igy/
肠梗阻	igz/
重婚案	iha/
陈华彬	ihb/
长河村	ihc/
闯红灯	ihd/
吃喝儿	ihe/
吃盒饭	ihf/
吃火锅	ihg/
超豪华	ihh/
乘火车	ihi/
传呼机	ihj/
出海口	ihk/
成活率	ihl/
城隍庙	ihm/
茶花女	ihn/
车号牌	ihp/
成华区	ihq/
陈奂仁	ihr/
橙黄色	ihs/
吹火筒	iht/
巢湖市	ihu/
长河中	ihv/
楚怀王	ihw/
吃海鲜	ihx/
持欢迎	ihy/
重婚罪	ihz/
出差啊	iia/
传抄本	iib/
出差错	iic/
出产地	iid/
长串儿	iie/
出场费	iif/
超常规	iig/
常常会	iih/
冲冲冲	iii/
出厂价	iij/
长城卡	iik/
超出了	iil/
撑场面	iim/
初川南	iin/
长翅鸥	iio/
出产品	iip/
除尘器	iiq/
长春人	iir/
长椿寺	iis/
常春藤	iit/
长春市	iiu/
充斥着	iiv/
车窗外	iiw/
常出现	iix/
驰骋于	iiy/
穿插在	iiz/
吃鸡啊	ija/
常见病	ijb/
持久层	ijc/
常见的	ijd/
成交额	ije/
冲击法	ijf/
成就感	ijg/
持久化	ijh/
成绩差	iji/
成交价	ijj/
长江口	ijk/
成交量	ijl/
陈炯明	ijm/
出嫁女	ijn/
出精品	ijp/
春节前	ijq/
出家人	ijr/
城建司	ijs/
长镜头	ijt/
纯净水	iju/
创建者	ijv/
沉积物	ijw/
持久性	ijx/
创建于	ijy/
沉浸在	ijz/
超可爱	ika/
重刊本	ikb/
吃快餐	ikc/
出口到	ikd/
出口额	ike/
创客坊	ikf/
出口国	ikg/
创刊号	ikh/
出口处	iki/
成克杰	ikj/
串口卡	ikk/
出口量	ikl/
车库门	ikm/
长裤男	ikn/
喘口气	ikq/
持卡人	ikr/
超快速	iks/
创可贴	ikt/
出口商	iku/
出口值	ikv/
陈楷雯	ikw/
吃空饷	ikx/
创刊于	iky/
长裤子	ikz/
出来啊	ila/
出来吧	ilb/
处理层	ilc/
处理的	ild/
茶卤儿	ile/
差旅费	ilf/
陈列馆	ilg/
成立后	ilh/
处理厂	ili/
超链接	ilj/
岔路口	ilk/
成立了	ill/
出了门	ilm/
除了你	iln/
处理品	ilp/
常量区	ilq/
城里人	ilr/
车轮锁	ils/
除了他	ilt/
陈老师	ilu/
车轮战	ilv/
处理完	ilw/
楚留香	ilx/
成立于	ily/
矗立在	ilz/
穿棉袄	ima/
触摸板	imb/
长睦村	imc/
崇明岛	imd/
长毛儿	ime/
吃米饭	imf/
称美国	img/
陈慕华	imh/
陈牧驰	imi/
传媒界	imj/
城门口	imk/
充满了	iml/
重命名	imm/
长命女	imn/
橙蜜藕	imo/
触摸屏	imp/
出门前	imq/
出卖人	imr/
长命锁	ims/
长毛兔	imt/
出门时	imu/
充满着	imv/
车迷网	imw/
崇明县	imx/
沉迷于	imy/
成名作	imz/
吹牛逼	inb/
城南村	inc/
处女地	ind/
丑奴儿	ine/
处女峰	inf/
炒年糕	ing/
处女航	inh/
出纳处	ini/
刹那间	inj/
朝南开	ink/
超能力	inl/
处女膜	inm/
纯牛奶	inn/
吹牛皮	inp/
长宁区	inq/
成年人	inr/
超浓缩	ins/
出难题	int/
承诺书	inu/
承诺制	inv/
场内外	inw/
长宁县	inx/
沉溺于	iny/
处女座	inz/
戳破啊	ipa/
敞篷版	ipb/
常平仓	ipc/
长跑队	ipd/
唱片儿	ipe/
吃派饭	ipf/
吃苹果	ipg/
车牌号	iph/
敞篷车	ipi/
产品奖	ipj/
成品库	ipk/
成品粮	ipl/
唱片名	ipm/
臭皮囊	ipn/
吹泡泡	ipp/
昌平区	ipq/
持票人	ipr/
陈佩斯	ips/
吃葡萄	ipt/
吃偏食	ipu/
车牌照	ipv/
触碰我	ipw/
产品线	ipx/
成品油	ipy/
产品组	ipz/
传球啊	iqa/
拆迁办	iqb/
炒芹菜	iqc/
重启动	iqd/
岔曲儿	iqe/
拆迁费	iqf/
唱起歌	iqg/
拆迁户	iqh/
乘汽车	iqi/
产权界	iqj/
长期看	iqk/
出去了	iql/
陈其迈	iqm/
厂区内	iqn/
穿旗袍	iqp/
吹气球	iqq/
拆迁人	iqr/
重庆赛	iqs/
常青藤	iqt/
重庆市	iqu/
产权证	iqv/
出去玩	iqw/
长期性	iqx/
场强仪	iqy/
穿裙子	iqz/
传染病	irb/
出人才	irc/
肠蠕动	ird/
陈润儿	ire/
出让方	irf/
传染给	irg/
成人化	irh/
唱日出	iri/
出入境	irj/
出入口	irk/
朝日铃	irl/
出人命	irm/
成人票	irp/
超人气	irq/
出让人	irr/
炒肉丝	irs/
超然台	irt/
承认是	iru/
缠绕着	irv/
成人网	irw/
传染性	irx/
传染源	iry/
缠绕在	irz/
陈思安	isa/
车速表	isb/
炒三脆	isc/
传送到	isd/
穿丧服	isf/
炒丝瓜	isg/
除四害	ish/
陈思诚	isi/
长三角	isj/
常思考	isk/
褚遂良	isl/
传送门	ism/
插死你	isn/
成碎片	isp/
差速器	isq/
愁死人	isr/
差速锁	iss/
查斯特	ist/
吃素食	isu/
穿梭着	isv/
成思危	isw/
车损险	isx/
柴松岳	isy/
重孙子	isz/
长梯隘	ita/
冲突表	itb/
柴田聪	itc/
畅通的	itd/
尺头儿	ite/
长途费	itf/
床头柜	itg/
出台后	ith/
衬托出	iti/
朝天椒	itj/
赤铁矿	itk/
出台了	itl/
朝天门	itm/
出头鸟	itn/
冲天炮	itp/
朝天区	itq/
纯天然	itr/
承天寺	its/
赤条条	itt/
传统上	itu/
冲突中	itv/
称他为	itw/
传统型	itx/
锄头雨	ity/
吃桃子	itz/
程十安	iua/
超声波	iub/
传输层	iuc/
城市的	iud/
揣手儿	iue/
程十发	iuf/
吃水果	iug/
初始化	iuh/
产生出	iui/
长时间	iuj/
出水口	iuk/
产生了	iul/
吃什么	ium/
瞅啥呢	iun/
超水平	iup/
城市群	iuq/
创始人	iur/
崇圣寺	ius/
吃食堂	iut/
长沙市	iuu/
城市中	iuv/
出售物	iuw/
传输线	iux/
出生于	iuy/
尝试做	iuz/
沉重啊	iva/
成正比	ivb/
潮州菜	ivc/
沉重的	ivd/
初装费	ivf/
成长股	ivg/
城镇化	ivh/
持支持	ivi/
传真机	ivj/
充值卡	ivk/
陈至立	ivl/
车主们	ivm/
楚昭南	ivn/
陈志朋	ivp/
成长期	ivq/
持证人	ivr/
撑着伞	ivs/
垂着头	ivt/
常州市	ivu/
持这种	ivv/
称之为	ivw/
成长性	ivx/
出主意	ivy/
初中组	ivz/
丑闻案	iwa/
超文本	iwb/
吃晚餐	iwc/
宠物店	iwd/
臭味儿	iwe/
吃完饭	iwf/
宠物狗	iwg/
常委会	iwh/
超外差	iwi/
除味剂	iwj/
朝外开	iwk/
成为了	iwl/
崇文门	iwm/
宠物女	iwn/
陈屋坡	iwp/
崇文区	iwq/
陈伟容	iwr/
查韦斯	iws/
出问题	iwt/
窗外事	iwu/
乘务长	iwv/
成为我	iww/
常温下	iwx/
乘务员	iwy/
纯文字	iwz/
重新爱	ixa/
程序包	ixb/
吃西餐	ixc/
抽象的	ixd/
成宿儿	ixe/
程序法	ixf/
出现过	ixg/
程序化	ixh/
呈现出	ixi/
陈小姐	ixj/
储蓄卡	ixk/
出现了	ixl/
肠系膜	ixm/
城西南	ixn/
扯闲篇	ixp/
撤销权	ixq/
除息日	ixr/
储蓄所	ixs/
扯闲天	ixt/
陈先生	ixu/
初学者	ixv/
陈锡文	ixw/
创新性	ixx/
程序员	ixy/
出现在	ixz/
陈元安	iya/
创业板	iyb/
臭氧层	iyc/
差一点	iyd/
串秧儿	iye/
穿衣服	iyf/
出一个	iyg/
产业化	iyh/
乘用车	iyi/
柴油机	iyj/
陈寅恪	iyk/
产业链	iyl/
朝阳门	iym/
乘晕宁	iyn/
常用品	iyp/
朝阳区	iyq/
承运人	iyr/
超音速	iys/
成一团	iyt/
倡议书	iyu/
创业者	iyv/
城域网	iyw/
差异性	iyx/
创业园	iyy/
赤眼鳟	iyz/
陈子昂	iza/
朝左边	izb/
吃早餐	izc/
充足的	izd/
出资额	ize/
出租房	izf/
出租给	izg/
迟早会	izh/
出租车	izi/
称自己	izj/
创造了	izl/
车仔面	izm/
杵在那	izn/
车字旁	izp/
承租权	izq/
承租人	izr/
成紫色	izs/
厂字头	izt/
创作室	izu/
创造者	izv/
出租屋	izw/
创造性	izx/
出自于	izy/
沉醉在	izz/
祭敖包	jab/
甲岸村	jac/
骄傲的	jad/
吉奥夫	jaf/
骄傲感	jag/
晋安河	jah/
教案集	jaj/
金奥康	jak/
甲胺磷	jal/
军爱民	jam/
吉安娜	jan/
静安区	jaq/
静安寺	jas/
捷安特	jat/
吉安市	jau/
聚氨酯	jav/
靖安王	jaw/
吉安县	jax/
骄傲月	jay/
贾庵子	jaz/
江北岸	jba/
就不必	jbb/
就不错	jbc/
疾病的	jbd/
剧本儿	jbe/
基本法	jbf/
基本功	jbg/
就不会	jbh/
就变成	jbi/
就比较	jbj/
就不可	jbk/
举办了	jbl/
即表明	jbm/
就不能	jbn/
姜拌藕	jbo/
就不怕	jbp/
经不起	jbq/
接班人	jbr/
锦标赛	jbs/
就不同	jbt/
基本上	jbu/
禁不住	jbv/
几百万	jbw/
就必须	jbx/
就不要	jby/
就不再	jbz/
计财部	jcb/
决策层	jcc/
精彩的	jcd/
缴存额	jce/
教材费	jcf/
夹层锅	jcg/
检测后	jch/
检测出	jci/
就曾经	jcj/
计财科	jck/
记错了	jcl/
纠错码	jcm/
荆莿鸟	jcn/
酱菜瓶	jcp/
寄存器	jcq/
寄存人	jcr/
据测算	jcs/
九层塔	jct/
决策树	jcu/
决策者	jcv/
监测网	jcw/
紧凑型	jcx/
仅次于	jcy/
就存在	jcz/
记得啊	jda/
仅代表	jdb/
莙荙菜	jdc/
巨大的	jdd/
聚堆儿	jde/
鉴定费	jdf/
精度高	jdg/
机顶盒	jdh/
机动车	jdi/
基督教	jdj/
街道口	jdk/
决定了	jdl/
季度末	jdm/
见到你	jdn/
记得哦	jdo/
解毒片	jdp/
继电器	jdq/
鉴定人	jdr/
鉴定所	jds/
基督徒	jdt/
绝对是	jdu/
景德镇	jdv/
记得我	jdw/
阶段性	jdx/
监督员	jdy/
局党组	jdz/
己二胺	jea/
继而被	jeb/
杰尔村	jec/
饥饿的	jed/
饥饿感	jeg/
姜恩惠	jeh/
假恶丑	jei/
焦恩俊	jej/
寄蛾科	jek/
经二路	jel/
姐儿们	jem/
九二年	jen/
九耳犬	jeq/
己二酸	jes/
卷耳兔	jet/
金恩圣	jeu/
加尔文	jew/
巨恶心	jex/
洁尔阴	jey/
纠纷案	jfa/
见附表	jfb/
记分册	jfc/
寄放到	jfd/
加富尔	jfe/
减肥法	jff/
交付给	jfg/
解放后	jfh/
就非常	jfi/
解放军	jfj/
积分卡	jfk/
解放路	jfl/
几方面	jfm/
金发男	jfn/
假发票	jfp/
军分区	jfq/
金夫人	jfr/
积分赛	jfs/
简繁体	jft/
就发生	jfu/
几分钟	jfv/
金饭碗	jfw/
就发现	jfx/
减肥药	jfy/
较复杂	jfz/
军购案	jga/
价格比	jgb/
就干脆	jgc/
较高的	jgd/
究根儿	jge/
加工费	jgf/
价格高	jgg/
结构化	jgh/
加工厂	jgi/
经国家	jgj/
警告框	jgk/
经过了	jgl/
见过吗	jgm/
交给你	jgn/
加工品	jgp/
激光器	jgq/
几个人	jgr/
就告诉	jgs/
结构图	jgt/
结果是	jgu/
及各种	jgv/
经过我	jgw/
结构性	jgx/
几个月	jgy/
几个字	jgz/
金海岸	jha/
结核病	jhb/
角化层	jhc/
较好的	jhd/
绝活儿	jhe/
就恢复	jhf/
将会给	jhg/
结婚后	jhh/
救护车	jhi/
交换机	jhj/
军火库	jhk/
就好了	jhl/
激活码	jhm/
就很难	jhn/
江湖派	jhp/
精华区	jhq/
监护人	jhr/
金黄色	jhs/
精华帖	jht/
几乎是	jhu/
计划中	jhv/
聚合物	jhw/
就好像	jhx/
就会有	jhy/
将会在	jhz/
结肠癌	jia/
监察部	jib/
家常菜	jic/
接触的	jid/
急茬儿	jie/
继承法	jif/
检察官	jig/
经常会	jih/
计程车	jii/
监察局	jij/
进出口	jik/
就成了	jil/
接触面	jim/
金翅鸟	jin/
蒋锄欧	jio/
基础篇	jip/
继承权	jiq/
继承人	jir/
检查所	jis/
监察厅	jit/
基础上	jiu/
进程中	jiv/
将成为	jiw/
基础性	jix/
检察院	jiy/
检查组	jiz/
姐姐啊	jja/
经济报	jjb/
经济舱	jjc/
积极的	jjd/
酒劲儿	jje/
经济法	jjf/
局机关	jjg/
基金会	jjh/
交界处	jji/
经济界	jjj/
借记卡	jjk/
解决了	jjl/
假睫毛	jjm/
近几年	jjn/
奇奇偶	jjo/
咀嚼片	jjp/
经济区	jjq/
节假日	jjr/
急加速	jjs/
经济体	jjt/
仅仅是	jju/
紧接着	jjv/
家教网	jjw/
积极性	jjx/
就具有	jjy/
纪检组	jjz/
健康宝	jkb/
架空层	jkc/
艰苦的	jkd/
进口额	jke/
借款方	jkf/
进口国	jkg/
进口货	jkh/
进口车	jki/
就看见	jkj/
据可靠	jkk/
加快了	jkl/
健康码	jkm/
就可能	jkn/
寄卡片	jkp/
经开区	jkq/
借款人	jkr/
教科所	jks/
就靠他	jkt/
就开始	jku/
健康证	jkv/
健康网	jkw/
杰克逊	jkx/
就可以	jky/
解扣子	jkz/
家里啊	jla/
俱乐部	jlb/
经理层	jlc/
记录的	jld/
捡漏儿	jle/
家乐福	jlf/
经历过	jlg/
交流会	jlh/
教练车	jli/
据了解	jlj/
就立刻	jlk/
建立了	jll/
见了面	jlm/
近两年	jln/
纪录片	jlp/
建立起	jlq/
净利润	jlr/
降落伞	jls/
九龙塘	jlt/
吉林省	jlu/
记录着	jlv/
九龙湾	jlw/
纪律性	jlx/
教练员	jly/
建立在	jlz/
救命啊	jma/
就明白	jmb/
健美操	jmc/
加盟店	jmd/
碱面儿	jme/
就没法	jmf/
睫毛膏	jmg/
见面会	jmh/
就卖出	jmi/
金马奖	jmj/
家门口	jmk/
将面临	jml/
姐妹们	jmm/
吉木乃	jmn/
假名牌	jmp/
解码器	jmq/
竞买人	jmr/
佳木斯	jms/
经贸厅	jmt/
加盟商	jmu/
节目中	jmv/
经贸委	jmw/
急慢性	jmx/
就没有	jmy/
节目组	jmz/
纪念碑	jnb/
纪念册	jnc/
加拿大	jnd/
吉诺尔	jne/
纪念封	jnf/
纪念馆	jng/
嘉年华	jnh/
今年初	jni/
胶囊剂	jnj/
就能看	jnk/
近年来	jnl/
就那么	jnm/
几年内	jnn/
纪念品	jnp/
几年前	jnq/
纪念日	jnr/
吉尼斯	jns/
纪念堂	jnt/
济南市	jnu/
几年中	jnv/
境内外	jnw/
技能型	jnx/
就难以	jny/
金牛座	jnz/
奇偶比	job/
金瓯村	joc/
紧耦合	joh/
解偶联	jol/
建瓯市	jou/
奇偶性	jox/
精辟啊	jpa/
金牌榜	jpb/
机炮舱	jpc/
精品店	jpd/
京牌儿	jpe/
鸡扒饭	jpf/
紧迫感	jpg/
镜泊湖	jph/
吉普车	jpi/
精品集	jpj/
检票口	jpk/
就跑了	jpl/
金瓶梅	jpm/
就怕你	jpn/
急拍拍	jpp/
金平区	jpq/
监票人	jpr/
键盘锁	jps/
精品帖	jpt/
给排水	jpu/
经批准	jpv/
精品屋	jpw/
紧迫性	jpx/
交朋友	jpy/
浸泡在	jpz/
金钱案	jqa/
加强版	jqb/
进球彩	jqc/
坚强的	jqd/
焦圈儿	jqe/
就缺乏	jqf/
居全国	jqg/
进去后	jqh/
讲清楚	jqi/
金球奖	jqj/
进气口	jqk/
加起来	jql/
机器猫	jqm/
几千年	jqn/
激情片	jqp/
静悄悄	jqq/
机器人	jqr/
就轻松	jqs/
及其他	jqt/
近亲属	jqu/
加气站	jqv/
几千万	jqw/
交强险	jqx/
几千元	jqy/
就去做	jqz/
竟然把	jrb/
皆如此	jrc/
惊人的	jrd/
金融法	jrf/
金融股	jrg/
就如何	jrh/
金日成	jri/
金融街	jrj/
借入款	jrk/
进入了	jrl/
家人们	jrm/
假如你	jrn/
即日起	jrq/
就让人	jrr/
聚乳酸	jrs/
就如同	jrt/
竟然是	jru/
继任者	jrv/
就认为	jrw/
兼容性	jrx/
金融业	jry/
居然在	jrz/
金粟庵	jsa/
极速版	jsb/
检索词	jsc/
加速度	jsd/
加塞儿	jse/
计算法	jsf/
肌酸酐	jsg/
金丝猴	jsh/
计算出	jsi/
计算机	jsj/
金穗卡	jsk/
就算了	jsl/
角色名	jsm/
近三年	jsn/
金算盘	jsp/
计算器	jsq/
金丝绒	jsr/
计算所	jss/
计算题	jst/
江苏省	jsu/
寄宿制	jsv/
即所谓	jsw/
橘色心	jsx/
近似于	jsy/
金嗓子	jsz/
集团案	jta/
交通部	jtb/
今天才	jtc/
就听到	jtd/
鸡腿儿	jte/
交通费	jtf/
仅提供	jtg/
几天后	jth/
就提出	jti/
据统计	jtj/
静态库	jtk/
据透露	jtl/
叫他们	jtm/
几天内	jtn/
就突破	jtp/
监听器	jtq/
就突然	jtr/
加图索	jts/
交通厅	jtt/
今天是	jtu/
家庭中	jtv/
据台湾	jtw/
交通线	jtx/
今天有	jty/
今天在	jtz/
就是啊	jua/
建设部	jub/
就是从	juc/
坚实的	jud/
记事儿	jue/
健身房	juf/
几十个	jug/
结束后	juh/
经审查	jui/
建设局	juj/
精神科	juk/
介绍了	jul/
叫什么	jum/
几十年	jun/
就是哦	juo/
警示牌	jup/
计数器	juq/
驾驶人	jur/
加时赛	jus/
就是他	jut/
即使是	juu/
建设中	juv/
就是我	juw/
介绍信	jux/
就是要	juy/
就是在	juz/
记住啊	jva/
就准备	jvb/
角质层	jvc/
竞争的	jvd/
叫真儿	jve/
截止阀	jvf/
价值观	jvg/
家长会	jvh/
就指出	jvi/
胶粘剂	jvj/
贾樟柯	jvk/
竞争力	jvl/
就这么	jvm/
就只能	jvn/
接住哦	jvo/
剪纸片	jvp/
居住区	jvq/
见证人	jvr/
稽征所	jvs/
晶状体	jvt/
记者说	jvu/
竞争中	jvv/
建筑物	jvw/
集装箱	jvx/
就这样	jvy/
集中在	jvz/
蒋万安	jwa/
巨无霸	jwb/
进晚餐	jwc/
郊外的	jwd/
京味儿	jwe/
就无法	jwf/
就我国	jwg/
居委会	jwh/
教务处	jwi/
鸡尾酒	jwj/
教务科	jwk/
就完了	jwl/
叫我们	jwm/
九五年	jwn/
假文凭	jwp/
就完全	jwq/
局外人	jwr/
肌萎缩	jws/
金维他	jwt/
家务事	jwu/
交往中	jwv/
吉娃娃	jww/
经纬线	jwx/
几万元	jwy/
教务组	jwz/
聚酰胺	jxa/
教学班	jxb/
进销存	jxc/
较小的	jxd/
畸形儿	jxe/
教学法	jxf/
据香港	jxg/
机械化	jxh/
机械厂	jxi/
奖学金	jxj/
杰西卡	jxk/
进行了	jxl/
将姓名	jxm/
近些年	jxn/
教学片	jxp/
集线器	jxq/
机械人	jxr/
就迅速	jxs/
将系统	jxt/
经销商	jxu/
进行中	jxv/
吉祥物	jxw/
局限性	jxx/
就需要	jxy/
巨蟹座	jxz/
加油啊	jya/
进一步	jyb/
鉴于此	jyc/
经营的	jyd/
交易额	jye/
将依法	jyf/
就应该	jyg/
交易会	jyh/
卷烟厂	jyi/
教育局	jyj/
教育科	jyk/
就有了	jyl/
精英们	jym/
建议您	jyn/
加油哦	jyo/
教育片	jyp/
经营权	jyq/
交易日	jyr/
交易所	jys/
教育厅	jyt/
教研室	jyu/
经营者	jyv/
局域网	jyw/
经营性	jyx/
教研员	jyy/
教研组	jyz/
净资本	jzb/
将再次	jzc/
将再度	jzd/
叫座儿	jze/
捐赠法	jzf/
就足够	jzg/
就做好	jzh/
净资产	jzi/
将增加	jzj/
集资款	jzk/
就醉了	jzl/
江泽民	jzm/
就在那	jzn/
橘子皮	jzp/
加载器	jzq/
就自然	jzr/
酱紫色	jzs/
金字塔	jzt/
建造师	jzu/
就在这	jzv/
就在我	jzw/
加载项	jzx/
就在于	jzy/
就坐在	jzz/
可爱哎	kaa/
可爱吧	kab/
刻凹槽	kac/
可爱多	kad/
可爱花	kah/
苦艾酒	kaj/
邝安堃	kak/
可爱捏	kan/
凯奥斯	kas/
开安镇	kav/
抗癌性	kax/
抗癌药	kay/
抗艾滋	kaz/
快播案	kba/
可辨别	kbb/
可保存	kbc/
看不到	kbd/
坎贝尔	kbe/
课本费	kbf/
看病贵	kbg/
科博会	kbh/
看不出	kbi/
看不见	kbj/
魁北克	kbk/
开办了	kbl/
可避免	kbm/
看病难	kbn/
恐怖片	kbp/
看不起	kbq/
可辨认	kbr/
魁拔四	kbs/
可不填	kbt/
可不是	kbu/
可保证	kbv/
快步舞	kbw/
可比性	kbx/
康拜因	kby/
快步走	kbz/
快餐部	kcb/
柯厝村	kcc/
快餐店	kcd/
康采恩	kce/
开采法	kcf/
开餐馆	kcg/
口才好	kch/
可存储	kci/
开槽机	kcj/
可参考	kck/
库存量	kcl/
看财奴	kcn/
看测评	kcp/
开采权	kcq/
枯草热	kcr/
快餐厅	kct/
看参数	kcu/
可参照	kcv/
可擦写	kcx/
可采用	kcy/
可操作	kcz/
快点啊	kda/
肯定不	kdb/
看丹村	kdc/
肯定的	kdd/
坑点儿	kde/
快递费	kdf/
看到过	kdg/
肯定会	kdh/
卡丁车	kdi/
肯德基	kdj/
空对空	kdk/
看到了	kdl/
看到吗	kdm/
看到你	kdn/
快点哦	kdo/
刻度盘	kdp/
跨地区	kdq/
看得人	kdr/
抗毒素	kds/
看大图	kdt/
肯定是	kdu/
可定制	kdv/
看到我	kdw/
可读性	kdx/
看电影	kdy/
口袋罪	kdz/
克尔白	keb/
库尔德	ked/
扣额法	kef/
酷二狗	keg/
坎儿井	kej/
廓尔喀	kek/
库尔勒	kel/
卡尔马	kem/
科尔沁	keq/
块儿肉	ker/
凯恩斯	kes/
凯尔特	ket/
夸娥氏	keu/
开尔文	kew/
看儿子	kez/
开放啊	kfa/
开发部	kfb/
咖啡豆	kfd/
库福尔	kfe/
开发费	kff/
咖啡馆	kfg/
咖啡壶	kfh/
开发出	kfi/
看风景	kfj/
卡夫卡	kfk/
开发了	kfl/
靠父母	kfm/
卡凡妮	kfn/
开发票	kfp/
开发区	kfq/
开放日	kfr/
咖啡色	kfs/
咖啡厅	kft/
开发商	kfu/
开发者	kfv/
可分为	kfw/
开放性	kfx/
口服液	kfy/
孔夫子	kfz/
肯干啊	kga/
可改变	kgb/
苦甘草	kgc/
客观的	kgd/
苦工夫	kgf/
开关柜	kgg/
可更换	kgh/
开关厂	kgi/
可根据	kgj/
开个孔	kgk/
看过了	kgl/
抗过敏	kgm/
拷给你	kgn/
看鬼片	kgp/
看过去	kgq/
抗干扰	kgr/
开公司	kgs/
客观题	kgt/
客观上	kgu/
恐高症	kgv/
快给我	kgw/
客观性	kgx/
可归于	kgy/
嗑瓜子	kgz/
考核表	khb/
客户端	khd/
开盒儿	khe/
可恢复	khf/
开或关	khg/
开户行	khh/
刻画出	khi/
客户机	khj/
夸海口	khk/
看好了	khl/
开户名	khm/
括号内	khn/
看好哦	kho/
科幻片	khp/
客户群	khq/
看护人	khr/
开化寺	khs/
卡后台	kht/
库函数	khu/
哭喊着	khv/
开化县	khx/
跨行业	khy/
恐吓罪	khz/
开车啊	kia/
开场白	kib/
可储存	kic/
宽敞的	kid/
烤串儿	kie/
可重复	kif/
昆虫馆	kig/
扛长活	kih/
客车厂	kii/
抗冲击	kij/
肯吃苦	kik/
开创了	kil/
开车门	kim/
咳喘宁	kin/
矿产品	kip/
开车去	kiq/
可传染	kir/
考察团	kit/
看成是	kiu/
开创者	kiv/
开场舞	kiw/
可持续	kix/
勘察院	kiy/
考察组	kiz/
课教案	kja/
科技部	kjb/
课间操	kjc/
科技的	kjd/
可劲儿	kje/
会计法	kjf/
科技馆	kjg/
开机后	kjh/
科技处	kji/
快捷键	kjj/
靠进口	kjk/
看见了	kjl/
卡介苗	kjm/
看见你	kjn/
科教片	kjp/
可减轻	kjq/
可进入	kjr/
抗菌素	kjs/
科技厅	kjt/
可减少	kju/
空间站	kjv/
看见我	kjw/
会计学	kjx/
科技园	kjy/
快节奏	kjz/
看看啊	kka/
看看吧	kkb/
坑口村	kkc/
可靠的	kkd/
考科二	kke/
开口饭	kkf/
可控硅	kkg/
开口呼	kkh/
可看出	kki/
卡卡鸡	kkj/
快快快	kkk/
开口了	kkl/
看看吗	kkm/
看看你	kkn/
叩叩趴	kkp/
可卡犬	kkq/
烤烤肉	kkr/
科科斯	kks/
看看他	kkt/
开口说	kku/
可扩展	kkv/
看看我	kkw/
可靠性	kkx/
可卡因	kky/
空壳子	kkz/
快乐啊	kla/
克虏伯	klb/
康乐村	klc/
考虑到	kld/
克莱尔	kle/
克里夫	klf/
考虑过	klg/
抗老化	klh/
刻录成	kli/
刻录机	klj/
看了看	klk/
卡路里	kll/
开了门	klm/
克鲁尼	kln/
刻录盘	klp/
卡拉奇	klq/
克隆人	klr/
卡洛斯	kls/
骷髅头	klt/
看来是	klu/
快乐着	klv/
看来我	klw/
垦利县	klx/
可利用	kly/
酷路泽	klz/
开门啊	kma/
看明白	kmb/
开幕词	kmc/
孔明灯	kmd/
靠门儿	kme/
开模费	kmf/
看门狗	kmg/
开门红	kmh/
昆明池	kmi/
抗磨剂	kmj/
库模块	kmk/
喀麦隆	kml/
寇萌萌	kmm/
看美女	kmn/
开门炮	kmp/
卡曼奇	kmq/
凯美瑞	kmr/
康明斯	kms/
宽面条	kmt/
开幕式	kmu/
康美镇	kmv/
科目五	kmw/
抗磨性	kmx/
可没有	kmy/
可满足	kmz/
坎宁安	kna/
可能不	knb/
坑南村	knc/
可能的	knd/
卡尼尔	kne/
开暖风	knf/
坤宁宫	kng/
可能会	knh/
空鸟巢	kni/
可能就	knj/
柯尼卡	knk/
困难了	knl/
可能吗	knm/
烤牛奶	knn/
烤牛排	knp/
开暖气	knq/
烤牛肉	knr/
喀纳斯	kns/
卡诺图	knt/
可能是	knu/
困难者	knv/
可能为	knw/
可能性	knx/
可能因	kny/
可能在	knz/
科普部	kpb/
开普敦	kpd/
开瓢儿	kpe/
开瓶费	kpf/
开瓶盖	kpg/
恐怕会	kph/
开辟出	kpi/
开盘价	kpj/
卡普空	kpk/
开辟了	kpl/
宽屏幕	kpm/
恐怕你	kpn/
可偏偏	kpp/
开瓶器	kpq/
考评人	kpr/
开票所	kps/
跨平台	kpt/
恐怕是	kpu/
渴盼着	kpv/
宽频网	kpw/
康平县	kpx/
恐怕要	kpy/
考评组	kpz/
口腔癌	kqa/
狂犬病	kqb/
孔雀草	kqc/
可取的	kqd/
开气儿	kqe/
可区分	kqf/
空缺感	kqg/
坑钱货	kqh/
看清楚	kqi/
考勤机	kqj/
口腔科	kqk/
看起来	kql/
哭泣猫	kqm/
空气囊	kqn/
孔雀牌	kqp/
柯桥区	kqq/
看球赛	kqs/
空气跳	kqt/
矿泉水	kqu/
空气中	kqv/
孔雀王	kqw/
可取消	kqx/
烤全羊	kqy/
克钦族	kqz/
坑人啊	kra/
可燃冰	krb/
科任村	krc/
客人的	krd/
开刃儿	kre/
开热风	krf/
克瑞格	krg/
烤肉串	kri/
苦肉计	krj/
快让开	krk/
客容量	krl/
客人们	krm/
可容纳	krn/
克瑞强	krq/
可容忍	krr/
看热搜	krs/
廓如亭	krt/
可认识	kru/
困扰着	krv/
可燃物	krw/
可溶性	krx/
可任意	kry/
苦日子	krz/
哭丧棒	ksb/
卡斯翠	ksc/
快速的	ksd/
亏损额	kse/
扩散法	ksf/
苦涩感	ksg/
快速化	ksh/
快速乘	ksi/
抗酸剂	ksj/
库萨克	ksk/
渴死了	ksl/
亏损面	ksm/
坑死你	ksn/
卡萨鹏	ksp/
开赛前	ksq/
坑死人	ksr/
堪萨斯	kss/
喀斯特	kst/
可随时	ksu/
可随着	ksv/
坑死我	ksw/
可塑性	ksx/
可随意	ksy/
可塑造	ksz/
开团啊	kta/
空调病	ktb/
坑头村	ktc/
可替代	ktd/
卡塔尔	kte/
考托福	ktf/
可通过	ktg/
开通后	kth/
空调车	kti/
可调节	ktj/
康泰克	ktk/
开通了	ktl/
看他们	ktm/
科托努	ktn/
卡通片	ktp/
空调器	ktq/
烤兔肉	ktr/
可调速	kts/
卡通图	ktt/
课堂上	ktu/
开拓者	ktv/
可眺望	ktw/
开拓性	ktx/
口蹄疫	kty/
课题组	ktz/
快说啊	kua/
开始吧	kub/
可谁曾	kuc/
可适当	kud/
口哨儿	kue/
康师傅	kuf/
开始干	kug/
可视化	kuh/
可生产	kui/
开始就	kuj/
跨时空	kuk/
开始了	kul/
看什么	kum/
可是你	kun/
开视频	kup/
看上去	kuq/
可输入	kur/
抗生素	kus/
可是他	kut/
开始时	kuu/
口水战	kuv/
可是我	kuw/
可实现	kux/
可使用	kuy/
开始做	kuz/
控制板	kvb/
扩展槽	kvc/
扩展到	kvd/
柯镇恶	kve/
控制阀	kvf/
靠这个	kvg/
可转换	kvh/
可支持	kvi/
可直接	kvj/
扩展卡	kvk/
开展了	kvl/
扩展名	kvm/
看着你	kvn/
可支配	kvp/
控制器	kvq/
科主任	kvr/
可追溯	kvs/
看着他	kvt/
可真是	kvu/
控制着	kvv/
看着我	kvw/
扩展性	kvx/
跨专业	kvy/
控制在	kvz/
可恶啊	kwa/
枯萎病	kwb/
开胃菜	kwc/
渴望的	kwd/
康沃尔	kwe/
考务费	kwf/
开外挂	kwg/
看完后	kwh/
可维持	kwi/
库文件	kwj/
开网课	kwk/
看完了	kwl/
靠我们	kwm/
矿物泥	kwn/
看外婆	kwp/
可我却	kwq/
科沃斯	kws/
科威特	kwt/
刊物上	kwu/
矿物质	kwv/
看外网	kww/
开玩笑	kwx/
矿物油	kwy/
可望在	kwz/
可惜啊	kxa/
科学部	kxb/
空心菜	kxc/
开心的	kxd/
卡西尔	kxe/
可修复	kxf/
开心果	kxg/
科学化	kxh/
可消除	kxi/
科学家	kxj/
跨学科	kxk/
可惜了	kxl/
看行吗	kxm/
苛性钠	kxn/
卡西欧	kxo/
凯旋炮	kxp/
看下去	kxq/
可信任	kxr/
苦行僧	kxs/
口香糖	kxt/
可享受	kxu/
苦笑着	kxv/
看新闻	kxw/
可行性	kxx/
科学院	kxy/
可选择	kxz/
可以啊	kya/
可以把	kyb/
可以从	kyc/
可以的	kyd/
跨院儿	kye/
开药方	kyf/
开一个	kyg/
抗氧化	kyh/
可以吃	kyi/
空压机	kyj/
看一看	kyk/
可以了	kyl/
可以吗	kym/
可以拿	kyn/
可以哦	kyo/
烤鱼片	kyp/
可以去	kyq/
可以让	kyr/
科研所	kys/
烤羊腿	kyt/
可以说	kyu/
客运站	kyv/
康有为	kyw/
可以向	kyx/
可以用	kyy/
看样子	kyz/
抗组胺	kza/
可咋办	kzb/
咔滋脆	kzc/
枯燥的	kzd/
克孜尔	kze/
宽字符	kzf/
抗灾歌	kzg/
可组合	kzh/
筷子长	kzi/
靠自己	kzj/
卡兹克	kzk/
看资料	kzl/
孔子庙	kzm/
可憎娘	kzn/
馈赠品	kzp/
看足球	kzq/
可再生	kzu/
可组织	kzv/
快做完	kzw/
孔子像	kzx/
孔子曰	kzy/
靠左走	kzz/
恋爱吧	lab/
龙安村	lac/
劳埃德	lad/
恋爱观	lag/
磷铵厂	lai/
离岸价	laj/
拉奥孔	lak/
立案率	lal/
老阿妈	lam/
丽安娜	lan/
来安排	lap/
梁爱琪	laq/
恋爱日	lar/
赖氨酸	las/
立案庭	lat/
六安市	lau/
刘安庄	lav/
立昂微	law/
隆安县	lax/
老阿姨	lay/
联苯胺	lba/
李冰冰	lbb/
辣白菜	lbc/
了不得	lbd/
两半儿	lbe/
两部分	lbf/
淋巴管	lbg/
罗宾汉	lbh/
刘伯承	lbi/
零部件	lbj/
离不开	lbk/
淋巴瘤	lbl/
老板们	lbm/
老板娘	lbn/
凉拌藕	lbo/
罗布泊	lbp/
了不起	lbq/
六百人	lbr/
礼拜四	lbs/
路边摊	lbt/
来表示	lbu/
留不住	lbv/
两不误	lbw/
老百姓	lbx/
利比亚	lby/
两步走	lbz/
靓彩版	lcb/
绿葱葱	lcc/
流窜到	lcd/
老词儿	lce/
六次方	lcf/
来参观	lcg/
冷餐会	lch/
冷藏车	lci/
来参加	lcj/
冷藏库	lck/
两层楼	lcl/
老财迷	lcm/
楼采凝	lcn/
两层皮	lcp/
李沧区	lcq/
搂错人	lcr/
李灿森	lcs/
刘苍苔	lct/
理财师	lcu/
留存着	lcv/
另存为	lcw/
冷藏箱	lcx/
柳残阳	lcy/
流操作	lcz/
老弟啊	lda/
劳动部	ldb/
领导层	ldc/
量大的	ldd/
蓝底儿	lde/
劳动法	ldf/
老大哥	ldg/
刘德华	ldh/
锂电池	ldi/
来得及	ldj/
蓝点颏	ldk/
劳动力	ldl/
领导们	ldm/
老大难	ldn/
拉大片	ldp/
领导权	ldq/
领导人	ldr/
兰德斯	lds/
来代替	ldt/
娄底市	ldu/
劳动者	ldv/
拉丁舞	ldw/
领导下	ldx/
林黛玉	ldy/
拉肚子	ldz/
蓝耳病	leb/
鹿儿岛	led/
卢恩光	leg/
鲁尔河	leh/
李二口	lek/
柳二龙	lel/
绿恶魔	lem/
李二牛	len/
灵恩派	lep/
罗尔斯	les/
老儿童	let/
腊尔山	leu/
李恩珠	lev/
李尔王	lew/
来恶心	lex/
李恩雅	ley/
老儿子	lez/
蓝佛安	lfa/
冷风暴	lfb/
联丰村	lfc/
理发店	lfd/
棱缝儿	lfe/
类方法	lff/
卢浮宫	lfg/
立法会	lfh/
列方程	lfi/
拉法基	lfj/
乱罚款	lfk/
浪费了	lfl/
立方米	lfm/
礼服呢	lfn/
利福平	lfp/
立法权	lfq/
老夫人	lfr/
隆福寺	lfs/
立方体	lft/
廊坊市	lfu/
来访者	lfv/
李风伟	lfw/
零风险	lfx/
罗非鱼	lfy/
老房子	lfz/
老公啊	lga/
老干部	lgb/
两个词	lgc/
乐观的	lgd/
拉呱儿	lge/
兰桂坊	lgf/
老公公	lgg/
泸沽湖	lgh/
类固醇	lgi/
两国间	lgj/
理工科	lgk/
理工类	lgl/
老革命	lgm/
留给你	lgn/
滤光片	lgp/
龙岗区	lgq/
两个人	lgr/
两公司	lgs/
老骨头	lgt/
零关税	lgu/
罗贯中	lgv/
留给我	lgw/
连贯性	lgx/
两个月	lgy/
两个字	lgz/
厉害啊	lha/
拦洪坝	lhb/
六合彩	lhc/
良好的	lhd/
拉花儿	lhe/
莲花峰	lhf/
联合国	lhg/
联合会	lhh/
令狐冲	lhi/
老虎机	lhj/
老河口	lhk/
来衡量	lhl/
癞蛤蟆	lhm/
氯化钠	lhn/
里海鸥	lho/
老虎皮	lhp/
罗湖区	lhq/
老好人	lhr/
刘海粟	lhs/
联合体	lht/
老和尚	lhu/
李鸿章	lhv/
硫化物	lhw/
灵活性	lhx/
落后于	lhy/
撩汉子	lhz/
卵巢癌	lia/
里程碑	lib/
老陈醋	lic/
流畅的	lid/
理茬儿	lie/
流川枫	lif/
蓝筹股	lig/
流产后	lih/
李长春	lii/
连城诀	lij/
李昌奎	lik/
露出了	lil/
冷冲模	lim/
老处女	lin/
林产品	lip/
老城区	liq/
刘纯如	lir/
理查森	lis/
流程图	lit/
聊城市	liu/
流传着	liv/
梁朝伟	liw/
流畅性	lix/
类成员	liy/
六重奏	liz/
垃圾啊	lja/
溜肩膀	ljb/
连接词	ljc/
了解到	ljd/
老家儿	lje/
龙卷风	ljf/
连接管	ljg/
两句话	ljh/
李嘉诚	lji/
辣椒酱	ljj/
连脚裤	ljk/
零距离	ljl/
邻居们	ljm/
雷吉纳	ljn/
逻辑盘	ljp/
连接器	ljq/
梁静茹	ljr/
联交所	ljs/
垃圾桶	ljt/
连接数	lju/
连接着	ljv/
理解为	ljw/
连接线	ljx/
凌驾于	ljy/
陆家嘴	ljz/
李克昂	lka/
铝扣板	lkb/
零库存	lkc/
利库德	lkd/
两口儿	lke/
李开复	lkf/
老客户	lkh/
路口处	lki/
离开家	lkj/
来看看	lkk/
离开了	lkl/
勒克猫	lkm/
离开你	lkn/
冷空气	lkq/
李可染	lkr/
卢卡斯	lks/
轮廓图	lkt/
离开时	lku/
类扩展	lkv/
离开我	lkw/
轮廓线	lkx/
林科院	lky/
两口子	lkz/
来了啊	lla/
履历表	llb/
链路层	llc/
流利的	lld/
流浪儿	lle/
李林甫	llf/
浏览过	llg/
老龄化	llh/
流露出	lli/
流量计	llj/
理论课	llk/
啦啦啦	lll/
来了吗	llm/
李莉娜	lln/
琉璃藕	llo/
伦理片	llp/
浏览器	llq/
联络人	llr/
劳伦斯	lls/
聊聊天	llt/
理论上	llu/
浏览者	llv/
琉璃瓦	llw/
伦理学	llx/
联络员	lly/
锂离子	llz/
蕾缪安	lma/
联盟杯	lmb/
联绵词	lmc/
灵敏度	lmd/
隆美尔	lme/
罗马法	lmf/
两面光	lmg/
冷门货	lmh/
李莫愁	lmi/
朗姆酒	lmj/
冷面孔	lmk/
罗梅罗	lml/
刘某某	lmm/
里米尼	lmn/
罗密欧	lmo/
两面派	lmp/
老母亲	lmq/
罗马人	lmr/
氯霉素	lms/
流媒体	lmt/
路面上	lmu/
栏目中	lmv/
李梦雯	lmw/
两面性	lmx/
里面有	lmy/
联绵字	lmz/
雷诺阿	lna/
两年半	lnb/
老奴才	lnc/
两年多	lnd/
老蔫儿	lne/
老农夫	lnf/
练内功	lng/
两年后	lnh/
罱泥船	lni/
六年级	lnj/
朗尼克	lnk/
两年来	lnl/
老鸟们	lnm/
两年内	lnn/
岭南派	lnp/
两年前	lnq/
老年人	lnr/
莱妮丝	lns/
类囊体	lnt/
辽宁省	lnu/
绿内障	lnv/
留尼汪	lnw/
老年性	lnx/
颅内压	lny/
路怒族	lnz/
李欧梵	lof/
利欧路	lol/
蕾欧娜	lon/
溜藕片	lop/
里欧斯	los/
莲藕汤	lot/
老婆啊	lpa/
老婆饼	lpb/
洛佩慈	lpc/
礼品店	lpd/
老炮儿	lpe/
零排放	lpf/
癞皮狗	lpg/
礼品盒	lph/
蓝牌车	lpi/
零配件	lpj/
礼品卡	lpk/
良品率	lpl/
两匹马	lpm/
懒婆娘	lpn/
老婆婆	lpp/
礼品券	lpq/
洛佩斯	lps/
莲蓬头	lpt/
六盘水	lpu/
领跑者	lpv/
来赔我	lpw/
梁平县	lpx/
老朋友	lpy/
亮牌子	lpz/
拉齐奥	lqa/
老前辈	lqb/
龙泉村	lqc/
篮球队	lqd/
雷切尔	lqe/
来区分	lqf/
列全国	lqg/
冷却后	lqh/
梁启超	lqi/
链球菌	lqj/
两千块	lqk/
录取率	lql/
留情面	lqm/
两千年	lqn/
路绮欧	lqo/
林清平	lqp/
滤清器	lqq/
老情人	lqr/
篮球赛	lqs/
冷却塔	lqt/
冷却水	lqu/
李清照	lqv/
两千万	lqw/
林青霞	lqx/
冷却液	lqy/
刘渠子	lqz/
拉瑞安	lra/
利润表	lrb/
论人才	lrc/
落入到	lrd/
利润额	lre/
两人份	lrf/
蜡人馆	lrg/
罗荣桓	lrh/
落日城	lri/
老人家	lrj/
林蚺科	lrk/
利润率	lrl/
老人们	lrm/
录入难	lrn/
鹿肉片	lrp/
罗瑞卿	lrq/
乐融融	lrr/
兰若寺	lrs/
老人头	lrt/
来认识	lru/
梁荣忠	lrv/
懒人翁	lrw/
烈日下	lrx/
刘若英	lry/
李睿泽	lrz/
硫酸铵	lsa/
绿色版	lsb/
两三次	lsc/
类似的	lsd/
拉丝儿	lse/
罗斯福	lsf/
两三个	lsg/
离散化	lsh/
梁思成	lsi/
刘三姐	lsj/
螺丝扣	lsk/
懒死了	lsl/
硫酸镁	lsm/
两三年	lsn/
老色批	lsp/
临死前	lsq/
累死人	lsr/
辣丝丝	lss/
两三天	lst/
拉萨市	lsu/
磷酸酯	lsv/
硫酸雾	lsw/
硫酸锌	lsx/
类似于	lsy/
傈僳族	lsz/
聊天啊	lta/
论坛报	ltb/
乐透彩	ltc/
鹿特丹	ltd/
老头儿	lte/
骆驼峰	ltf/
流通股	ltg/
两天后	lth/
轮胎厂	lti/
楼梯间	ltj/
灵通卡	ltk/
论坛里	ltl/
令他们	ltm/
聊天呢	ltn/
老太婆	ltp/
两天前	ltq/
蓝田人	ltr/
擂台赛	lts/
老太太	ltt/
聊天室	ltu/
老同志	ltv/
立陶宛	ltw/
离退休	ltx/
老天爷	lty/
老头子	ltz/
刘少昂	lua/
零售版	lub/
老鼠仓	luc/
历史的	lud/
零售额	lue/
乱收费	luf/
领事馆	lug/
理事会	luh/
留守处	lui/
零售价	luj/
历史课	luk/
论述了	lul/
老师们	lum/
六十年	lun/
梁山泊	lup/
刘少奇	luq/
老实人	lur/
六十岁	lus/
论述题	lut/
历史上	luu/
理事长	luv/
律师网	luw/
来实现	lux/
零售业	luy/
冷水澡	luz/
零障碍	lva/
冷轧板	lvb/
灵芝草	lvc/
两者都	lvd/
冷招儿	lve/
来征服	lvf/
龙之谷	lvg/
论证会	lvh/
良种场	lvi/
老专家	lvj/
廖仲恺	lvk/
来这里	lvl/
来证明	lvm/
来找你	lvn/
老照片	lvp/
联轴器	lvq/
两种人	lvr/
龙舟赛	lvs/
搂着他	lvt/
兰州市	lvu/
笼罩着	lvv/
来找我	lvw/
李肇星	lvx/
老中医	lvy/
笼罩在	lvz/
来玩啊	lwa/
来玩吧	lwb/
狼尾草	lwc/
领悟到	lwd/
狼窝儿	lwe/
劳务费	lwf/
螺纹钢	lwg/
礼物盒	lwh/
来完成	lwi/
论文集	lwj/
两万块	lwk/
里外里	lwl/
令我们	lwm/
罗威纳	lwn/
利物浦	lwp/
卢湾区	lwq/
两万人	lwr/
劳务所	lws/
老顽童	lwt/
两位数	lwu/
落伍者	lwv/
论文网	lww/
李文秀	lwx/
两万元	lwy/
略微再	lwz/
老乡啊	lxa/
流行病	lxb/
练习册	lxc/
理想的	lxd/
露馅儿	lxe/
陆小凤	lxf/
老戏骨	lxg/
理想化	lxh/
旅行车	lxi/
连续剧	lxj/
联系卡	lxk/
留下了	lxl/
老乡们	lxm/
李先念	lxn/
郎咸平	lxp/
联想起	lxq/
联系人	lxr/
流行色	lxs/
练习题	lxt/
旅行社	lxu/
旅行者	lxv/
刘心武	lxw/
连续性	lxx/
领先于	lxy/
螺旋藻	lxz/
李英爱	lya/
留言板	lyb/
另一侧	lyc/
另一端	lyd/
雷亚尔	lye/
另一方	lyf/
另一个	lyg/
联谊会	lyh/
炼油厂	lyi/
旅游局	lyj/
另一块	lyk/
利用率	lyl/
另一面	lym/
领域内	lyn/
李亚鹏	lyp/
路由器	lyq/
留言人	lyr/
路易斯	lys/
另一条	lyt/
洛阳市	lyu/
另一种	lyv/
另一位	lyw/
另一些	lyx/
来源于	lyy/
老爷子	lyz/
陆子昂	lza/
帘子布	lzb/
两字词	lzc/
立足点	lzd/
遛早儿	lze/
廉租房	lzf/
老资格	lzg/
老字号	lzh/
李自成	lzi/
连自己	lzj/
来做客	lzk/
笼子里	lzl/
老总们	lzm/
拎走你	lzn/
栗子坪	lzp/
临走前	lzq/
李宗仁	lzr/
蓝紫色	lzs/
离子烫	lzt/
临走时	lzu/
连载中	lzv/
廉子文	lzw/
林则徐	lzx/
来自于	lzy/
老祖宗	lzz/
漠澳鵖	mab/
民安村	mac/
明暗度	mad/
梅爱芳	maf/
没爱过	mag/
梅阿查	mai/
没挨浇	maj/
没爱了	mal/
迈阿密	mam/
莫阿娜	man/
没安排	map/
毛岸青	maq/
默哀日	mar/
每盎司	mas/
买安踏	mat/
马鞍山	mau/
免安装	mav/
马鞍形	max/
毛岸英	may/
马鞍子	maz/
没白熬	mba/
米吧币	mbb/
木板材	mbc/
买不到	mbd/
买本儿	mbe/
没办法	mbf/
瞒不过	mbg/
迈巴赫	mbh/
面包车	mbi/
面包机	mbj/
抹不开	mbk/
明白了	mbl/
买不买	mbm/
每半年	mbn/
鸣不平	mbp/
买不起	mbq/
明白人	mbr/
莫泊桑	mbs/
美波桃	mbt/
目标是	mbu/
摸不着	mbv/
没把握	mbw/
买保险	mbx/
没必要	mby/
漫步在	mbz/
冇错啊	mca/
没错吧	mcb/
莽苍苍	mcc/
每次都	mcd/
毛寸儿	mce/
迷彩服	mcf/
没凑够	mcg/
贸促会	mch/
木材厂	mci/
没参加	mcj/
马草夼	mck/
摩擦力	mcl/
摩擦面	mcm/
猫踩奶	mcn/
买彩票	mcp/
煤层气	mcq/
没厕所	mcs/
摩擦声	mcu/
埋藏着	mcv/
茅草屋	mcw/
摩擦学	mcx/
麻仓优	mcy/
每次在	mcz/
没的啊	mda/
木地板	mdb/
麦冬草	mdc/
目的地	mdd/
门洞儿	mde/
没地方	mdf/
没打过	mdg/
牡丹花	mdh/
毛滴虫	mdi/
牡丹江	mdj/
牡丹卡	mdk/
麦当劳	mdl/
面对面	mdm/
麦当娜	mdn/
蒙迪欧	mdo/
牡丹皮	mdp/
买得起	mdq/
买的人	mdr/
没打算	mds/
牡丹亭	mdt/
目的是	mdu/
面对着	mdv/
每当我	mdw/
买东西	mdx/
牡丹园	mdy/
慢动作	mdz/
墨尔本	meb/
猫耳朵	med/
摩尔根	meg/
摩恩城	mei/
马尔贾	mej/
马尔康	mek/
马尔默	mem/
猫儿腻	men/
马恩牌	mep/
门儿清	meq/
摩尔人	mer/
迈尔斯	mes/
马耳他	met/
猫儿食	meu/
米尔扎	mev/
墨尔文	mew/
木耳乡	mex/
美尔雅	mey/
没儿子	mez/
麻烦啊	mfa/
免费版	mfb/
密封舱	mfc/
民法典	mfd/
没法儿	mfe/
免费发	mff/
密封膏	mfg/
满负荷	mfh/
面粉厂	mfi/
密封件	mfj/
免费看	mfk/
麻烦了	mfl/
某方面	mfm/
麻烦你	mfn/
免费品	mfp/
密封圈	mfq/
美妇人	mfr/
孟菲斯	mfs/
密封条	mft/
魔法师	mfu/
每分钟	mfv/
马蜂窝	mfw/
没发现	mfx/
没反应	mfy/
买房子	mfz/
蒙古包	mgb/
木格措	mgc/
敏感的	mgd/
麻秆儿	mge/
美国法	mgf/
蒙古国	mgg/
玫瑰花	mgh/
梦工厂	mgi/
每公斤	mgj/
莫高窟	mgk/
每公里	mgl/
米高梅	mgm/
梅甘娜	mgn/
买股票	mgp/
敏感区	mgq/
每个人	mgr/
母公司	mgs/
马锅头	mgt/
煤矸石	mgu/
敏感者	mgv/
名古屋	mgw/
没关系	mgx/
每个月	mgy/
蒙古族	mgz/
梦幻般	mhb/
抹灰层	mhc/
模糊的	mhd/
忙活儿	mhe/
毛混纺	mhf/
煤化工	mhg/
毛烘烘	mhh/
描绘出	mhi/
漫画家	mhj/
梅河口	mhk/
梅花鹿	mhl/
曼海姆	mhm/
卖花女	mhn/
马后炮	mhp/
闵行区	mhq/
孟浩然	mhr/
米黄色	mhs/
猕猴桃	mht/
没话说	mhu/
梅花针	mhv/
明洪武	mhw/
酶活性	mhx/
迷魂药	mhy/
毛孩子	mhz/
买长安	mia/
明抄本	mib/
莫愁村	mic/
慢车道	mid/
麦茬儿	mie/
梅超风	mif/
没吃过	mig/
莫愁湖	mih/
门窗厂	mii/
孟尝君	mij/
没吃亏	mik/
冒出来	mil/
名场面	mim/
卖茶女	min/
名产品	mip/
卖出去	miq/
明朝人	mir/
马车赛	mis/
暮春堂	mit/
名称上	miu/
明崇祯	miv/
冒充我	miw/
没出息	mix/
猫吃鱼	miy/
明成祖	miz/
麦角胺	mja/
毛巾被	mjb/
魔界村	mjc/
每季度	mjd/
麻经儿	mje/
每间房	mjf/
没见过	mjg/
没机会	mjh/
模具厂	mji/
麻将机	mjj/
每节课	mjk/
孟加拉	mjl/
门静脉	mjm/
孟姜女	mjn/
妙静鸥	mjo/
马家堡	mjp/
密集区	mjq/
没进入	mjr/
没结算	mjs/
没几天	mjt/
每件事	mju/
目击者	mjv/
面积为	mjw/
密集型	mjx/
面积约	mjy/
摩羯座	mjz/
命苦啊	mka/
妙控板	mkb/
没看错	mkc/
没看到	mkd/
迈克尔	mke/
麦克风	mkf/
没看过	mkg/
模块化	mkh/
没开成	mki/
没看见	mkj/
穆科科	mkk/
门开了	mkl/
木卡姆	mkm/
没可能	mkn/
没开票	mkp/
麦口期	mkq/
马克思	mks/
马口铁	mkt/
麦口上	mku/
没看着	mkv/
慕课网	mkw/
麦肯锡	mkx/
暮看云	mky/
没口子	mkz/
马里奥	mla/
马路边	mlb/
脉络丛	mlc/
猛烈的	mld/
每轮儿	mle/
梅兰芳	mlf/
摩洛哥	mlg/
命令行	mlh/
美联储	mli/
马六甲	mlj/
玫琳凯	mlk/
毛利率	mll/
摸了摸	mlm/
每两年	mln/
马力欧	mlo/
麻栗坡	mlp/
木兰情	mlq/
陌路人	mlr/
马拉松	mls/
麻辣烫	mlt/
马铃薯	mlu/
面临着	mlv/
马拉维	mlw/
没良心	mlx/
谋利益	mly/
麻雷子	mlz/
灭门案	mma/
没明白	mmb/
慢慢猜	mmc/
慢慢地	mmd/
麦芒儿	mme/
门面房	mmf/
面面观	mmg/
妈妈好	mmh/
毛毛虫	mmi/
磨煤机	mmj/
每门课	mmk/
慢慢来	mml/
马某某	mmm/
没骂娘	mmn/
妈卖批	mmp/
喵喵拳	mmq/
马某人	mmr/
密码锁	mms/
买买提	mmt/
明明是	mmu/
弥漫着	mmv/
命名为	mmw/
盲目性	mmx/
毛毛雨	mmy/
没面子	mmz/
美女啊	mna/
迷你版	mnb/
没内存	mnc/
美能达	mnd/
蒙乃尔	mne/
麦农肥	mnf/
摩纳哥	mng/
慕尼黑	mnh/
明年初	mni/
每年均	mnj/
莫妮卡	mnk/
马尼拉	mnl/
没那么	mnm/
没能耐	mnn/
没男票	mnp/
模拟器	mnq/
牦牛肉	mnr/
玛纳斯	mns/
模拟题	mnt/
模拟式	mnu/
默念着	mnv/
没挪窝	mnw/
迷你型	mnx/
木乃伊	mny/
满脑子	mnz/
木偶剧	moj/
木偶片	mop/
米欧奇	moq/
美欧日	mor/
木偶镇	mov/
美欧维	mow/
木偶戏	mox/
没品啊	mpa/
买平板	mpb/
名片册	mpc/
冒牌的	mpd/
没跑儿	mpe/
每平方	mpf/
马屁股	mpg/
门牌号	mph/
毛瓢虫	mpi/
名片夹	mpj/
没跑了	mpl/
每平米	mpm/
没骗你	mpn/
某品牌	mpp/
没脾气	mpq/
没骗人	mpr/
孟婆汤	mpt/
名片式	mpu/
麦片粥	mpv/
猫扑网	mpw/
牟平县	mpx/
马蓬瀛	mpy/
毛皮族	mpz/
没钱啊	mqa/
煤气表	mqb/
马桥村	mqc/
明确的	mqd/
米切尔	mqe/
买期房	mqf/
没去过	mqg/
母亲河	mqh/
摸清楚	mqi/
母亲节	mqj/
每千克	mqk/
米其林	mql/
没钱买	mqm/
曼奇尼	mqn/
没钱赔	mqp/
木器漆	mqq/
每千人	mqr/
喵千岁	mqs/
没前途	mqt/
米泉市	mqu/
免签证	mqv/
每千瓦	mqw/
明确性	mqx/
某企业	mqy/
煤气灶	mqz/
没人啊	mra/
美人豹	mrb/
没人才	mrc/
迷人的	mrd/
美人儿	mre/
毛人风	mrf/
没人敢	mrg/
猛如虎	mrh/
慕容垂	mri/
猛然间	mrj/
没人看	mrk/
名人录	mrl/
美人梅	mrm/
没人拿	mrn/
美容品	mrp/
美容器	mrq/
毛茸茸	mrr/
泌乳素	mrs/
名人堂	mrt/
美容师	mru/
默认值	mrv/
默认为	mrw/
敏锐性	mrx/
美容院	mry/
没人在	mrz/
钼酸铵	msa/
慢三步	msb/
民俗村	msc/
蜜三刀	msd/
曼苏尔	mse/
民诉法	msf/
没送过	msg/
马思慧	msh/
摸索出	msi/
马三家	msj/
莫斯科	msk/
穆斯林	msl/
没锁门	msm/
每三年	msn/
没碎片	msp/
马赛曲	msq/
迷死人	msr/
麻酥酥	mss/
民三庭	mst/
马嘶声	msu/
摸索着	msv/
穆萨维	msw/
民俗学	msx/
弥赛亚	msy/
美穗子	msz/
明天啊	mta/
马蹄表	mtb/
满堂彩	mtc/
没听到	mtd/
模特儿	mte/
满天飞	mtf/
门头沟	mtg/
满堂红	mth/
摩托车	mti/
茅台酒	mtj/
媒体库	mtk/
摩天轮	mtl/
面贴膜	mtm/
马提尼	mtn/
木托盘	mtp/
明天起	mtq/
木头人	mtr/
马桶塞	mts/
摩托艇	mtt/
每天上	mtu/
茅台镇	mtv/
孟庭苇	mtw/
满天星	mtx/
每天要	mty/
明太祖	mtz/
谋杀案	mua/
门市部	mub/
马师曾	muc/
陌生的	mud/
没事儿	mue/
描述符	muf/
美术馆	mug/
没说话	muh/
秘书处	mui/
门市价	muj/
美神葵	muk/
没事了	mul/
没什么	mum/
美少女	mun/
美术品	mup/
名胜区	muq/
陌生人	mur/
陌上桑	mus/
面试题	mut/
面试时	muu/
秘书长	muv/
美食网	muw/
模式下	mux/
灭鼠药	muy/
没事做	muz/
密执安	mva/
民政部	mvb/
免注册	mvc/
明智的	mvd/
每周二	mve/
门诊费	mvf/
满洲国	mvg/
民主化	mvh/
明珠城	mvi/
民政局	mvj/
魔咒课	mvk/
命中率	mvl/
没这么	mvm/
瞒着你	mvn/
木制品	mvp/
瞄准器	mvq/
每周日	mvr/
每周三	mvs/
莫扎特	mvt/
梅州市	mvu/
民主制	mvv/
每周五	mvw/
毛主席	mvx/
每周一	mvy/
煤砟子	mvz/
马尾辫	mwb/
马王村	mwc/
美味的	mwd/
木卫二	mwe/
拇外翻	mwf/
没玩过	mwg/
门外汉	mwh/
明王朝	mwi/
满文军	mwj/
没胃口	mwk/
明万历	mwl/
毛伟明	mwm/
没为难	mwn/
冥王篇	mwp/
莫维奇	mwq/
没污染	mwr/
马尾松	mws/
没问题	mwt/
猫喂食	mwu/
美纹纸	mwv/
莫文蔚	mww/
冥王星	mwx/
毛委员	mwy/
满屋子	mwz/
马西埃	mxa/
明细表	mxb/
母线槽	mxc/
明显的	mxd/
马歇尔	mxe/
买校服	mxf/
墨西哥	mxg/
梦醒后	mxh/
模型车	mxi/
冒险家	mxj/
毛细孔	mxk/
描写了	mxl/
明星们	mxm/
每学年	mxn/
明信片	mxp/
每学期	mxq/
某些人	mxr/
没心思	mxs/
每小题	mxt/
每小时	mxu/
明细账	mxv/
棉纤维	mxw/
没信心	mxx/
名学员	mxy/
慢性子	mxz/
没有啊	mya/
没有被	myb/
每一次	myc/
满意地	myd/
贸易额	mye/
买衣服	myf/
每一个	myg/
马缨花	myh/
每一处	myi/
马英九	myj/
每一款	myk/
没有了	myl/
每一名	mym/
每一年	myn/
没有哦	myo/
每一篇	myp/
没有钱	myq/
没有人	myr/
没意思	mys/
每一天	myt/
没有睡	myu/
每一种	myv/
每一位	myw/
每一项	myx/
没有用	myy/
煤烟子	myz/
名字啊	mza/
棉籽饼	mzb/
民族村	mzc/
毛泽东	mzd/
卖座儿	mze/
慢阻肺	mzf/
满足感	mzg/
民族化	mzh/
命最长	mzi/
名字叫	mzj/
麻醉科	mzk/
满足了	mzl/
没怎么	mzm/
满足你	mzn/
麻醉品	mzp/
麻醉枪	mzq/
满族人	mzr/
牟宗三	mzs/
髦字头	mzt/
面子上	mzu/
满载着	mzv/
民族舞	mzw/
民族乡	mzx/
满足于	mzy/
美滋滋	mzz/
南岸村	nac/
南澳岛	nad/
诺埃尔	nae/
你阿里	nal/
纳奥米	nam/
南岸区	naq/
鸟氨酸	nas/
你爱他	nat/
南安市	nau/
你安装	nav/
你爱我	naw/
农安县	nax/
耐奥祖	naz/
女保安	nba/
你不必	nbb/
你别猜	nbc/
拿不到	nbd/
尼泊尔	nbe/
那部分	nbf/
拗不过	nbg/
你不会	nbh/
南北朝	nbi/
脑白金	nbj/
南北宽	nbk/
内部类	nbl/
能避免	nbm/
能不能	nbn/
牛逼哦	nbo/
你别怕	nbp/
逆变器	nbq/
内部人	nbr/
那不算	nbs/
南霸天	nbt/
宁波市	nbu/
能帮助	nbv/
内部网	nbw/
你必须	nbx/
你不要	nby/
你不在	nbz/
念慈安	nca/
内测版	ncb/
你猜猜	ncc/
纳粹党	ncd/
女裁缝	ncf/
那才怪	ncg/
内测号	nch/
宁采臣	nci/
能促进	ncj/
内存卡	nck/
你错了	ncl/
内存门	ncm/
你猜呢	ncn/
南翠屏	ncp/
纳粹旗	ncq/
农村人	ncr/
女厕所	ncs/
内存条	nct/
你才是	ncu/
脑卒中	ncv/
你猜我	ncw/
奴才相	ncx/
南菜园	ncy/
内测组	ncz/
你的爱	nda/
你点吧	ndb/
你的错	ndc/
难得的	ndd/
纳达尔	nde/
嫩豆腐	ndf/
你的歌	ndg/
诺丁汉	ndh/
年代初	ndi/
南大街	ndj/
尿道口	ndk/
拿到了	ndl/
南大门	ndm/
男的呢	ndn/
年底前	ndq/
那当然	ndr/
内毒素	nds/
你对他	ndt/
你的手	ndu/
尿毒症	ndv/
能等我	ndw/
你的心	ndx/
尿道炎	ndy/
女弟子	ndz/
哪儿啊	nea/
那儿的	ned/
怒而飞	nef/
男儿歌	neg/
南二环	neh/
女儿茶	nei/
女儿家	nej/
哪儿了	nel/
娘儿们	nem/
女儿墙	neq/
尼尔森	nes/
你额头	net/
农二师	neu/
诺尔镇	nev/
纳尔逊	nex/
那儿有	ney/
你儿子	nez/
南方澳	nfa/
能分别	nfb/
鸟粪层	nfc/
你发的	nfd/
倪非凡	nff/
男法官	nfg/
农发行	nfh/
农夫茶	nfi/
女方家	nfj/
诺福克	nfk/
纽芬兰	nfl/
内分泌	nfm/
你放哪	nfn/
男反派	nfp/
南芬区	nfq/
南方人	nfr/
男粉丝	nfs/
内啡肽	nft/
耐腐蚀	nfu/
年发展	nfv/
南方网	nfw/
你放心	nfx/
农副业	nfy/
女飞贼	nfz/
你滚啊	nga/
能够把	ngb/
你刚才	ngc/
能干的	ngd/
念稿儿	nge/
宁国府	ngf/
你哥哥	ngg/
哪个好	ngh/
哪个厂	ngi/
牛肝菌	ngj/
牛冠凯	ngk/
拿过来	ngl/
你干嘛	ngm/
脑功能	ngn/
哪个哦	ngo/
哪个盘	ngp/
南岗区	ngq/
那个人	ngr/
脑梗塞	ngs/
你跟他	ngt/
那个啥	ngu/
你跟着	ngv/
你跟我	ngw/
农广校	ngx/
男高音	ngy/
能够在	ngz/
你好啊	nha/
你还不	nhb/
你好菜	nhc/
浓厚的	nhd/
女孩儿	nhe/
年后发	nhf/
你还敢	nhg/
你还会	nhh/
内河船	nhi/
内环境	nhj/
农行卡	nhk/
脑海里	nhl/
你好吗	nhm/
男或女	nhn/
拿好哦	nho/
奶黄派	nhp/
南海区	nhq/
内行人	nhr/
牛磺酸	nhs/
你和他	nht/
你还是	nhu/
脑海中	nhv/
您还未	nhw/
宁海县	nhx/
你还要	nhy/
女孩子	nhz/
囊虫病	nib/
耐储藏	nic/
黏稠度	nid/
弄潮儿	nie/
内插法	nif/
尿常规	nig/
霓裳花	nih/
你查查	nii/
耐冲击	nij/
能吃苦	nik/
年产量	nil/
啮齿目	nim/
弄成泥	nin/
农产品	nip/
南城区	niq/
牛初乳	nir/
南禅寺	nis/
脑垂体	nit/
南昌市	niu/
年产值	niv/
能成为	niw/
南朝鲜	nix/
年初一	niy/
那程子	niz/
你家啊	nja/
暖脚宝	njb/
南街村	njc/
你觉得	njd/
拈阄儿	nje/
能激发	njf/
那几个	njg/
你就会	njh/
能坚持	nji/
你究竟	njj/
能尽快	njk/
凝聚力	njl/
脑脊膜	njm/
那几年	njn/
拿奖牌	njp/
年纪轻	njq/
你居然	njr/
女祭司	njs/
那几天	njt/
那就是	nju/
凝聚着	njv/
你叫我	njw/
耐久性	njx/
诺基亚	njy/
年级组	njz/
内裤啊	nka/
那可不	nkb/
你可曾	nkc/
能看到	nkd/
尼克尔	nke/
能克服	nkf/
你看过	nkg/
哪款好	nkh/
男空乘	nki/
能看见	nkj/
你看看	nkk/
你看了	nkl/
你看嘛	nkm/
你看你	nkn/
诺坎普	nkp/
南开区	nkq/
男客人	nkr/
尼克斯	nks/
鸟瞰图	nkt/
南康市	nku/
能控制	nkv/
牛客网	nkw/
内科学	nkx/
你可以	nky/
尿裤子	nkz/
努力啊	nla/
努力吧	nlb/
年龄层	nlc/
那里的	nld/
娘俩儿	nle/
泥疗法	nlf/
你老公	nlg/
尼罗河	nlh/
能力差	nli/
能理解	nlj/
年历卡	nlk/
你来了	nll/
南联盟	nlm/
挠了挠	nln/
你老婆	nlp/
能力强	nlq/
年利润	nlr/
浓硫酸	nls/
那两条	nlt/
女老师	nlu/
奴隶制	nlv/
尼龙网	nlw/
年龄小	nlx/
哪里有	nly/
努力做	nlz/
那么爱	nma/
弄明白	nmb/
纳木错	nmc/
那么多	nmd/
娘们儿	nme/
农民房	nmf/
农民工	nmg/
那么好	nmh/
那么长	nmi/
那么就	nmj/
那么快	nmk/
你们了	nml/
农牧民	nmm/
那么难	nmn/
糯米哦	nmo/
宁玛派	nmp/
农牧区	nmq/
倪敏然	nmr/
柠檬酸	nms/
你每天	nmt/
女秘书	nmu/
柠檬汁	nmv/
那么我	nmw/
女明星	nmx/
您没有	nmy/
能满足	nmz/
闹呢啊	nna/
牛奶杯	nnb/
那男的	nnd/
你女儿	nne/
牛腩饭	nnf/
你哪个	nng/
那你还	nnh/
奶牛场	nni/
那你就	nnj/
男内裤	nnk/
你那里	nnl/
娘娘庙	nnm/
你你你	nnn/
男女排	nnp/
娘娘腔	nnq/
那女人	nnr/
尿囊素	nns/
牛奶糖	nnt/
南宁市	nnu/
你拿着	nnv/
南泥湾	nnw/
宁南县	nnx/
纳尼亚	nny/
努努嘴	nnz/
娘炮啊	npa/
牛皮本	npb/
内胚层	npc/
你拍的	npd/
脑瓢儿	npe/
你破防	npf/
牛排馆	npg/
纳帕海	nph/
脓疱疮	npi/
年平均	npj/
拿破仑	npl/
那匹马	npm/
能陪你	npn/
女乒乓	npp/
闹脾气	npq/
你骗人	npr/
内皮素	nps/
牛皮糖	npt/
哪怕是	npu/
牛皮纸	npv/
你陪我	npw/
牛皮癣	npx/
女朋友	npy/
女骗子	npz/
你去啊	nqa/
你去吧	nqb/
南齐村	nqc/
能起到	nqd/
暖气费	nqf/
暖气管	nqg/
年轻化	nqh/
弄清楚	nqi/
女骑警	nqj/
您请看	nqk/
扭曲了	nql/
女球迷	nqm/
女青年	nqn/
暖气片	nqp/
凝汽器	nqq/
年轻人	nqr/
你去死	nqs/
暖气团	nqt/
年轻时	nqu/
内墙砖	nqv/
内亲王	nqw/
闹情绪	nqx/
内切圆	nqy/
你签字	nqz/
女人啊	nra/
男人帮	nrb/
能如此	nrc/
女人都	nrd/
泥人儿	nre/
纳入法	nrf/
牛肉干	nrg/
女人会	nrh/
宁若初	nri/
内燃机	nrj/
你让开	nrk/
诺日朗	nrl/
男人们	nrm/
能容纳	nrn/
牛肉片	nrp/
女人气	nrq/
闹嚷嚷	nrr/
能仁寺	nrs/
牛肉汤	nrt/
内容是	nru/
聂荣臻	nrv/
你认为	nrw/
耐热性	nrx/
男人鱼	nry/
能死啊	nsa/
纽斯宝	nsb/
南孙村	nsc/
暖色调	nsd/
纳赛尔	nse/
纳素夫	nsf/
那三个	nsg/
南三环	nsh/
倪嗣冲	nsi/
耐酸碱	nsj/
内斯库	nsk/
难死了	nsl/
尿酸酶	nsm/
弄死你	nsn/
浓缩品	nsp/
浓缩器	nsq/
南宋人	nsr/
你搜搜	nss/
内斯塔	nst/
年三十	nsu/
浓缩汁	nsv/
脑死亡	nsw/
您所需	nsx/
浓缩液	nsy/
你退啊	nta/
女同胞	ntb/
内涂层	ntc/
能听懂	ntd/
那头儿	nte/
蔫土匪	ntf/
能通过	ntg/
哪天回	nth/
女体盛	nti/
那条街	ntj/
黏土矿	ntk/
那条路	ntl/
南天门	ntm/
那他呢	ntn/
钕铁硼	ntp/
那天起	ntq/
拟投入	ntr/
内廷司	nts/
逆淘汰	ntt/
女同事	ntu/
女同志	ntv/
女特务	ntw/
女同学	ntx/
能体验	nty/
年投资	ntz/
你傻啊	nua/
你身边	nub/
能生存	nuc/
南师大	nud/
纳税额	nue/
你是否	nuf/
你是个	nug/
那时候	nuh/
年生产	nui/
脑神经	nuj/
那时快	nuk/
泥石流	nul/
女士们	num/
你说呢	nun/
那是哦	nuo/
暖水瓶	nup/
南山区	nuq/
纳税人	nur/
女上司	nus/
逆渗透	nut/
你试试	nuu/
凝视着	nuv/
那是我	nuw/
耐受性	nux/
能使用	nuy/
你是自	nuz/
你猪啊	nva/
内政部	nvb/
耐贮藏	nvc/
你知道	nvd/
那阵儿	nve/
农转非	nvf/
你这个	nvg/
你真好	nvh/
女主持	nvi/
女主角	nvj/
你这款	nvk/
内置了	nvl/
那只猫	nvm/
女追男	nvn/
奶制品	nvp/
女知青	nvq/
女主人	nvr/
拿着伞	nvs/
男侦探	nvt/
那只是	nvu/
年长者	nvv/
你找我	nvw/
您只需	nvx/
你这样	nvy/
您正在	nvz/
内外部	nwb/
逆温层	nwc/
暖温带	nwd/
年味儿	nwe/
内务府	nwf/
泥瓦工	nwg/
傩文化	nwh/
内完成	nwi/
那我就	nwj/
脑外科	nwk/
纳瓦罗	nwl/
那我们	nwm/
那我呢	nwn/
聂卫平	nwp/
难为情	nwq/
挪威人	nwr/
脑萎缩	nws/
你我他	nwt/
男巫师	nwu/
凝望着	nwv/
你问我	nww/
内外销	nwx/
女网友	nwy/
内外资	nwz/
内酰胺	nxa/
脑细胞	nxb/
那些词	nxc/
内心的	nxd/
念想儿	nxe/
逆向法	nxf/
那些个	nxg/
你喜欢	nxh/
能宣传	nxi/
南小街	nxj/
囊形科	nxk/
你心里	nxl/
你信吗	nxm/
那些年	nxn/
牛小排	nxp/
南校区	nxq/
那些人	nxr/
浓硝酸	nxs/
那些天	nxt/
女学生	nxu/
年薪制	nxv/
女性为	nxw/
你想想	nxx/
你需要	nxy/
您现在	nxz/
哪有啊	nya/
农业部	nyb/
那一次	nyc/
你一定	nyd/
挠痒儿	nye/
年夜饭	nyf/
你应该	nyg/
女一号	nyh/
农用车	nyi/
你已经	nyj/
那一刻	nyk/
哪一类	nyl/
那一幕	nym/
那一年	nyn/
耐用品	nyp/
闹意气	nyq/
年月日	nyr/
奶油色	nys/
那一天	nyt/
农业税	nyu/
哪一种	nyv/
你以为	nyw/
耐用性	nyx/
你愿意	nyy/
那样做	nyz/
你在啊	nza/
牛仔布	nzb/
内灶村	nzc/
能做到	nzd/
奶嘴儿	nze/
牛仔服	nzf/
娘子关	nzg/
你最好	nzh/
酿造厂	nzi/
你自己	nzj/
牛仔裤	nzk/
脑子里	nzl/
你怎么	nzm/
你在哪	nzn/
牛字旁	nzp/
牛仔裙	nzq/
那自然	nzr/
女足赛	nzs/
您昨天	nzt/
那座山	nzu/
年增长	nzv/
农作物	nzw/
内在性	nzx/
牛仔衣	nzy/
女子组	nzz/
欧安会	oah/
区霭玲	oal/
欧倍德	obd/
偶不会	obh/
欧博城	obi/
欧伯利	obl/
欧巴马	obm/
欧倍青	obq/
欧巴桑	obs/
欧比特	obt/
哦不是	obu/
欧比旺	obw/
欧萃碧	ocb/
哦对了	odl/
欧迪玛	odm/
区大相	odx/
欧得洋	ody/
殴打罪	odz/
偶尔回	oeh/
偶尔咳	oek/
藕粉饺	ofj/
偶发性	ofx/
欧歌鸫	ogd/
欧共体	ogt/
欧会杯	ohb/
耦合度	ohd/
耦合器	ohq/
藕荷色	ohs/
偶函数	ohu/
欧皇斩	ohv/
耦合性	ohx/
哦还有	ohy/
耦合子	ohz/
欧超杯	oib/
欧查果	oig/
区楚良	oil/
欧车前	oiq/
呕出物	oiw/
欧家坝	ojb/
偶觉得	ojd/
欧嘉弗	ojf/
欧景乐	ojl/
欧锦赛	ojs/
藕节炭	ojt/
偶就是	oju/
偶剧系	ojx/
欧剑宇	ojy/
偶极子	ojz/
欧空局	okj/
欧克莱	okl/
欧克曼	okm/
欧克瑟	oks/
偶可以	oky/
欧罗巴	olb/
欧利伐	olf/
欧椋鸽	olg/
偶联剂	olj/
欧雷克	olk/
区乐民	olm/
欧椋鸟	oln/
欧林斯	ols/
鸥龙属	olu/
欧拉乡	olx/
欧莱雅	oly/
欧姆贝	omb/
欧麦尔	ome/
欧敏肤	omf/
欧麦格	omg/
欧明辉	omh/
欧米茄	omj/
欧玫珂	omk/
欧姆龙	oml/
欧美男	omn/
哦没事	omu/
欧美系	omx/
偶没有	omy/
欧尼尔	one/
欧尼熊	onx/
哦哦哦	ooo/
欧喷爱	opa/
欧佩克	opk/
欧珀莱	opl/
藕片汤	opt/
瓯浦垟	opy/
欧倩怡	oqy/
偶然的	ord/
偶然间	orj/
欧若拉	orl/
区瑞强	orq/
偶然说	oru/
偶然性	orx/
欧塞尔	ose/
藕丝糕	osg/
耦丝葵	osk/
欧特克	otk/
偶蹄类	otl/
偶蹄目	otm/
呕吐时	otu/
呕吐者	otv/
呕吐物	otw/
藕团乡	otx/
偶数班	oub/
欧舒丹	oud/
欧氏管	oug/
偶数号	ouh/
偶数场	oui/
欧时力	oul/
欧诗漫	oum/
偶数年	oun/
偶数排	oup/
欧盛霆	out/
欧神仙	oux/
偶数页	ouy/
区适子	ouz/
欧洲杯	ovb/
欧洲队	ovd/
欧洲化	ovh/
欧中建	ovj/
偶这里	ovl/
欧洲鳗	ovm/
欧洲区	ovq/
欧洲人	ovr/
欧洲司	ovs/
欧洲式	ovu/
欧洲行	ovx/
欧洲游	ovy/
欧委会	owh/
欧文虫	owi/
欧文斯	ows/
欧协杯	oxb/
欧溪村	oxc/
偶稀饭	oxf/
偶像化	oxh/
欧系车	oxi/
偶像剧	oxj/
欧协联	oxl/
鸥形目	oxm/
区晓鸥	oxo/
偶像派	oxp/
偶像学	oxx/
偶现在	oxz/
欧营村	oyc/
欧亚达	oyd/
欧阳锋	oyf/
欧元国	oyg/
欧阳红	oyh/
欧阳超	oyi/
欧阳炯	oyj/
欧阳克	oyk/
偶也来	oyl/
欧也妮	oyn/
欧元区	oyq/
欧阳通	oyt/
欧阳生	oyu/
欧阳贞	oyv/
欧阳文	oyw/
欧阳修	oyx/
欧阳勇	oyy/
藕圆子	oyz/
欧足联	ozl/
欧紫霞	ozx/
潘安邦	pab/
平安村	pac/
平安的	pad/
皮埃尔	pae/
平安符	paf/
平安谷	pag/
平安虎	pah/
平安茶	pai/
平安经	paj/
平安卡	pak/
破案率	pal/
爬啊爬	pap/
平安桥	paq/
脯氨酸	pas/
普安屯	pat/
普庵咒	pav/
磐安县	pax/
平安夜	pay/
破案子	paz/
派比安	pba/
屏蔽布	pbb/
屏蔽词	pbc/
疲惫的	pbd/
旁边儿	pbe/
漂白粉	pbf/
皮包骨	pbg/
普遍化	pbh/
平板车	pbi/
跑步机	pbj/
撇不开	pbk/
配备了	pbl/
屏蔽门	pbm/
陪伴你	pbn/
怕不怕	pbp/
屏蔽墙	pbq/
怕别人	pbr/
炮兵团	pbt/
配不上	pbu/
评比中	pbv/
屏蔽网	pbw/
普遍性	pbx/
配备有	pby/
陪伴在	pbz/
潘村村	pcc/
排错队	pcd/
碰瓷儿	pce/
仆从国	pcg/
拼凑出	pci/
平仓价	pcj/
派刺客	pck/
喷错了	pcl/
泡菜妹	pcm/
平采娜	pcn/
配菜盘	pcp/
评测人	pcr/
拍错拖	pct/
评测室	pcu/
泡菜味	pcw/
濮存昕	pcx/
拍苍蝇	pcy/
破大案	pda/
派代表	pdb/
排冬菜	pdc/
庞大的	pdd/
跑调儿	pde/
配电房	pdf/
平底锅	pdg/
彭德怀	pdh/
皮带秤	pdi/
盘点机	pdj/
跑得快	pdk/
碰到了	pdl/
跑得慢	pdm/
碰到你	pdn/
配电盘	pdp/
平等权	pdq/
胖的人	pdr/
帕丁森	pds/
判断题	pdt/
平顶山	pdu/
拍打着	pdv/
配电网	pdw/
配电箱	pdx/
拍电影	pdy/
破读字	pdz/
潘恩蓓	peb/
裴恩才	pec/
普二丁	ped/
派尔菲	pef/
裴二狗	peg/
片儿会	peh/
普洱茶	pei/
片儿警	pej/
排恶露	pel/
帕尔马	pem/
皮尔斯	pes/
帕尔特	pet/
普洱市	peu/
配额制	pev/
普洱县	pex/
皮肤癌	pfa/
皮肤病	pfb/
平方寸	pfc/
批发店	pfd/
跑分儿	pfe/
评分法	pff/
平方根	pfg/
平方和	pfh/
剖腹产	pfi/
批发价	pfj/
皮肤科	pfk/
排放量	pfl/
平方米	pfm/
佩服你	pfn/
平房区	pfq/
平凡人	pfr/
骗粉丝	pfs/
皮筏艇	pft/
批发商	pfu/
皮肤针	pfv/
漂浮物	pfw/
皮肤癣	pfx/
批发业	pfy/
票贩子	pfz/
膀胱癌	pga/
评估表	pgb/
苹果醋	pgc/
屁股蛋	pgd/
平跟儿	pge/
评估费	pgf/
拍广告	pgg/
袍哥会	pgh/
剖宫产	pgi/
苹果机	pgj/
扑个空	pgk/
跑过来	pgl/
怕个毛	pgm/
贫雇农	pgn/
苹果派	pgp/
跑过去	pgq/
凭个人	pgr/
苹果酸	pgs/
碰过头	pgt/
评估师	pgu/
旁观者	pgv/
配给我	pgw/
平跟鞋	pgx/
蒲公英	pgy/
爬格子	pgz/
彭怀安	pha/
排行榜	phb/
平湖村	phc/
平衡点	phd/
趴活儿	phe/
平衡阀	phf/
平衡感	phg/
配合好	phh/
泡壶茶	phi/
平滑肌	phj/
平衡块	phk/
破坏了	phl/
平衡木	phm/
潘汉年	phn/
拍黄片	php/
棚户区	phq/
澎湖人	phr/
品红色	phs/
皮划艇	pht/
平湖市	phu/
配合着	phv/
澎湖湾	phw/
破坏性	phx/
品行业	phy/
胖猴子	phz/
赔偿案	pia/
普查表	pib/
彭城村	pic/
偏差的	pid/
赔偿额	pie/
破产法	pif/
彭城国	pig/
排成行	pih/
爬长城	pii/
赔偿金	pij/
赔偿款	pik/
批处理	pil/
破处门	pim/
陪唱女	pin/
排成排	pip/
抛出去	piq/
平常人	pir/
派出所	pis/
跑长途	pit/
平常事	piu/
品尝着	piv/
排出物	piw/
平常心	pix/
普查员	piy/
平常在	piz/
破解版	pjb/
平价菜	pjc/
平静的	pjd/
皮筋儿	pje/
平均分	pjf/
破解过	pjg/
判决后	pjh/
配件厂	pji/
平均价	pjj/
皮夹克	pjk/
普及率	pjl/
片假名	pjm/
平均年	pjn/
迫击炮	pjp/
蓬江区	pjq/
评价人	pjr/
帕金森	pjs/
葡聚糖	pjt/
判决书	pju/
平均值	pjv/
平均为	pjw/
普及型	pjx/
潘家园	pjy/
仆街仔	pjz/
皮裤啊	pka/
派克笔	pkb/
贫困村	pkc/
平克顿	pkd/
拼块儿	pke/
平可夫	pkf/
贫困户	pkh/
平开窗	pki/
片刻间	pkj/
排扣裤	pkk/
潘卡罗	pkl/
皮克敏	pkm/
怕困难	pkn/
扑克牌	pkp/
浦口区	pkq/
皮克斯	pks/
浦科特	pkt/
贫困生	pku/
贫困者	pkv/
皮康王	pkw/
贫困县	pkx/
偏口鱼	pky/
攀靠在	pkz/
漂亮啊	pla/
漂亮吧	plb/
平流层	plc/
毗邻的	pld/
破烂儿	ple/
排列法	plf/
疲劳感	plg/
排卵后	plh/
排列成	pli/
评论家	plj/
普朗克	plk/
披露了	pll/
婆罗门	plm/
骗了你	pln/
拍了拍	plp/
排卵期	plq/
排卵日	plr/
普莱斯	pls/
跑龙套	plt/
评论数	plu/
评论者	plv/
霹雳舞	plw/
平罗县	plx/
评论员	ply/
普立兹	plz/
破棉袄	pma/
排名榜	pmb/
排名次	pmc/
拼命的	pmd/
帕米尔	pme/
怕麻烦	pmf/
破魔弓	pmg/
拍卖会	pmh/
跑马场	pmi/
喷码机	pmj/
贫民窟	pmk/
破灭了	pml/
泡美眉	pmm/
飘米娜	pmn/
拍马屁	pmp/
排名前	pmq/
拍卖人	pmr/
跑马赛	pms/
平面图	pmt/
屏幕上	pmu/
泡沫状	pmv/
拍卖网	pmw/
片面性	pmx/
拍卖业	pmy/
普米族	pmz/
怕你啊	pna/
陪你吧	pnb/
匹诺曹	pnc/
叛逆的	pnd/
跑哪儿	pne/
偏南风	pnf/
品尼高	png/
劈脑后	pnh/
陪你闯	pni/
陪你看	pnk/
派你来	pnl/
拍脑门	pnm/
帕努奇	pnq/
胖女人	pnr/
泼尼松	pns/
皮纳塔	pnt/
普宁市	pnu/
叛逆者	pnv/
陪你玩	pnw/
平南县	pnx/
陪你走	pnz/
配偶栏	pol/
配偶权	poq/
跑跑啊	ppa/
拍拍币	ppb/
抛抛蔡	ppc/
品牌店	ppd/
拍片儿	ppe/
翩翩飞	ppf/
枇杷膏	ppg/
品牌化	pph/
碰碰车	ppi/
品牌机	ppj/
拼拼看	ppk/
泡泡龙	ppl/
婆婆们	ppm/
帕帕尼	ppn/
啪啪啪	ppp/
乒乓球	ppq/
飘飘然	ppr/
爬爬赛	pps/
泡泡糖	ppt/
拍拍手	ppu/
批评者	ppv/
拍拍网	ppw/
批判性	ppx/
泡泡浴	ppy/
撇撇嘴	ppz/
脾气暴	pqb/
劈情操	pqc/
排球队	pqd/
跑圈儿	pqe/
排气阀	pqf/
排气管	pqg/
脾气好	pqh/
排球场	pqi/
派遣军	pqj/
排气口	pqk/
爬起来	pql/
普契尼	pqn/
曝气盘	pqp/
聘请去	pqq/
排球赛	pqs/
铍青铜	pqt/
排气扇	pqu/
剽窃者	pqv/
排球网	pqw/
迫切性	pqx/
盆腔炎	pqy/
碰巧在	pqz/
骗人布	prb/
骗人的	prd/
普瑞尔	pre/
烹饪法	prf/
裴如海	prh/
漂染厂	pri/
平日价	prj/
平日里	prl/
拼人气	prq/
蒲绒绒	prr/
派瑞松	prs/
膨润土	prt/
譬如说	pru/
聘任制	prv/
破任务	prw/
烹饪学	prx/
皮褥子	prz/
盘丝饼	psb/
朴素的	psd/
瓶塞儿	pse/
配送费	psf/
怕死鬼	psg/
盘损坏	psh/
怕塞车	psi/
破碎机	psj/
帕斯卡	psk/
蒲松龄	psl/
菩萨蛮	psm/
拍死你	psn/
配色盘	psp/
裴涩琪	psq/
排酸肉	psr/
扑簌簌	pss/
帕萨特	pst/
盘飧市	psu/
盘算着	psv/
判死刑	psx/
配速员	psy/
喷洒在	psz/
葡糖胺	pta/
排头兵	ptb/
葡萄村	ptc/
跑堂的	ptd/
跑堂儿	pte/
烹调法	ptf/
普通股	ptg/
普通话	pth/
普通车	pti/
葡萄酒	ptj/
拼图块	ptk/
泡汤了	ptl/
怕他们	ptm/
帕台农	ptn/
泡腾片	ptp/
普陀区	ptq/
普通人	ptr/
帕特森	pts/
葡萄糖	ptt/
平台上	ptu/
葡萄汁	ptv/
骈体文	ptw/
陪同下	ptx/
葡萄牙	pty/
葡萄籽	ptz/
抛尸案	pua/
喷射泵	pub/
派生词	puc/
朴实的	pud/
蒲式耳	pue/
评审费	puf/
排水管	pug/
评审会	puh/
派生出	pui/
泼水节	puj/
排水口	puk/
派生类	pul/
凭什么	pum/
毗湿奴	pun/
平射炮	pup/
爬上去	puq/
拍摄人	pur/
陪审团	put/
磐石市	puu/
拍摄者	puv/
派生物	puw/
平山县	pux/
平时要	puy/
铺设在	puz/
凭着爱	pva/
平装本	pvb/
盘中餐	pvc/
品种的	pvd/
朴正恩	pve/
辟支佛	pvf/
偏振光	pvg/
批准后	pvh/
评职称	pvi/
凭直觉	pvj/
偏执狂	pvk/
批准了	pvl/
朴哲民	pvm/
陪着你	pvn/
拍照片	pvp/
批准权	pvq/
批准人	pvr/
普照寺	pvs/
配置图	pvt/
批准书	pvu/
碰撞中	pvv/
陪着我	pvw/
皮脂腺	pvx/
偏重于	pvy/
拍桌子	pvz/
骗我啊	pwa/
潘玮柏	pwb/
埔尾村	pwc/
平屋顶	pwd/
陪玩儿	pwe/
排污费	pwf/
排污管	pwg/
评委会	pwh/
喷雾剂	pwj/
排污口	pwk/
跑完了	pwl/
评委们	pwm/
泡温泉	pwq/
庞维仁	pwr/
排位赛	pws/
帕瓦特	pwt/
皮外伤	pwu/
盼望着	pwv/
陪我玩	pww/
抛物线	pwx/
破玩意	pwy/
排湾族	pwz/
培训班	pxb/
埔心村	pxc/
平行度	pxd/
潘锡恩	pxe/
培训费	pxf/
平型关	pxg/
培训会	pxh/
评选出	pxi/
配线架	pxj/
螃蟹壳	pxk/
谱写了	pxl/
跑解马	pxm/
帕西诺	pxn/
拍胸脯	pxp/
劈下去	pxq/
派息日	pxr/
评选赛	pxs/
潘晓婷	pxt/
培训师	pxu/
培训者	pxv/
评选为	pxw/
平行线	pxx/
偏向于	pxy/
胖小子	pxz/
朋友啊	pya/
朋友吧	pyb/
聘英才	pyc/
颇有点	pyd/
普约尔	pye/
培养费	pyf/
派一个	pyg/
鄱阳湖	pyh/
培养出	pyi/
培养基	pyj/
排烟口	pyk/
偏移量	pyl/
朋友们	pym/
皮亚诺	pyn/
彭养鸥	pyo/
评一评	pyp/
番禺区	pyq/
培养人	pyr/
培养所	pys/
跑一趟	pyt/
濮阳市	pyu/
聘用制	pyv/
朋友问	pyw/
颇有些	pyx/
培养液	pyy/
评议组	pyz/
匹兹堡	pzb/
痞子蔡	pzc/
骗子多	pzd/
炮子儿	pze/
朴宰范	pzf/
盆栽哥	pzg/
片仔癀	pzh/
排子车	pzi/
怕自己	pzj/
瓶子里	pzl/
配字幕	pzm/
陪葬品	pzp/
排在前	pzq/
彭遵泗	pzs/
配子体	pzt/
盘子上	pzu/
拍杂志	pzv/
排座位	pzw/
彭泽县	pzx/
批作业	pzy/
帕祖祖	pzz/
气昂昂	qaa/
去爱吧	qab/
前垵村	qac/
亲爱的	qad/
抢暗杠	qag/
鞘氨醇	qai/
祁安路	qal/
曲阿奴	qan/
请安排	qap/
奇奥萨	qas/
清艾条	qat/
迁安市	qau/
请安装	qav/
秦安县	qax/
齐爱云	qay/
前北岸	qba/
情报部	qbb/
却不曾	qbc/
全部都	qbd/
桥边儿	qbe/
去北方	qbf/
七八个	qbg/
却不会	qbh/
七八成	qbi/
前不久	qbj/
切不可	qbk/
钱包里	qbl/
前辈们	qbm/
却不能	qbn/
气不平	qbp/
瞧不起	qbq/
却不如	qbr/
情报所	qbs/
丘比特	qbt/
岂不是	qbu/
却不知	qbv/
千百万	qbw/
漆包线	qbx/
请不要	qby/
卡脖子	qbz/
却从不	qcb/
前村村	qcc/
清脆的	qcd/
七次方	qcf/
去参观	qcg/
七彩虹	qch/
器材厂	qci/
请参见	qcj/
请参考	qck/
却从来	qcl/
抢菜买	qcm/
全彩屏	qcp/
起草人	qcr/
千层酥	qcs/
青菜头	qct/
其次是	qcu/
潜藏着	qcv/
却从未	qcw/
强磁性	qcx/
请参阅	qcy/
潜藏在	qcz/
期待爱	qda/
球蛋白	qdb/
抢到菜	qdc/
恰当的	qdd/
七对儿	qde/
清道夫	qdf/
齐墩果	qdg/
启动后	qdh/
骑单车	qdi/
请点击	qdj/
骑得快	qdk/
取得了	qdl/
骑的马	qdm/
黔东南	qdn/
启动盘	qdp/
驱动器	qdq/
签订日	qdr/
强调色	qds/
其独特	qdt/
青岛市	qdu/
期待着	qdv/
确定为	qdw/
启动项	qdx/
秋刀鱼	qdy/
启动组	qdz/
穷二代	qed/
权恩妃	qef/
邱娥国	qeg/
丘尔金	qej/
乔尔玛	qem/
去二年	qen/
企鹅牌	qep/
蛐儿蛐	qeq/
企鹅肉	qer/
企鹅头	qet/
雀儿山	qeu/
曲峨镇	qev/
圈儿外	qew/
切尔西	qex/
齐二药	qey/
亲儿子	qez/
千伏安	qfa/
全封闭	qfb/
秋风辞	qfc/
侵犯到	qfd/
区分法	qff/
清风阁	qfg/
且符合	qfh/
千分尺	qfi/
群发机	qfj/
区分开	qfk/
侵犯了	qfl/
全方面	qfm/
秦丰农	qfn/
群芳谱	qfp/
群发器	qfq/
欺负人	qfr/
氢氟酸	qfs/
欺负他	qft/
启发式	qfu/
求发展	qfv/
全方位	qfw/
启发性	qfx/
区法院	qfy/
起房子	qfz/
奇怪啊	qga/
乞丐版	qgb/
去观测	qgc/
穷光蛋	qgd/
枪杆儿	qge/
前滚翻	qgf/
亲哥哥	qgg/
庆功会	qgh/
全过程	qgi/
切割机	qgj/
其公开	qgk/
奇怪了	qgl/
请购买	qgm/
全功能	qgn/
齐广璞	qgp/
曲棍球	qgq/
七个人	qgr/
区公所	qgs/
请跟帖	qgt/
情感上	qgu/
请告知	qgv/
请各位	qgw/
全国性	qgx/
轻工业	qgy/
潜规则	qgz/
企划案	qha/
强化班	qhb/
青花瓷	qhc/
秦皇岛	qhd/
轻活儿	qhe/
请回复	qhf/
齐桓公	qhg/
青海湖	qhh/
七海雏	qhi/
取号机	qhj/
迁户口	qhk/
亲和力	qhl/
群号码	qhm/
氰化钠	qhn/
求和平	qhp/
琼华侨	qhq/
侵害人	qhr/
浅黄色	qhs/
签合同	qht/
青海省	qhu/
求婚者	qhv/
氰化物	qhw/
其核心	qhx/
全行业	qhy/
穷孩子	qhz/
起床啊	qia/
球虫病	qib/
全尺寸	qic/
清楚地	qid/
汽车儿	qie/
去吃饭	qif/
汽车股	qig/
起床后	qih/
汽车城	qii/
丘处机	qij/
请查看	qik/
清楚了	qil/
鞘翅目	qim/
汽车内	qin/
清楚哦	qio/
切成片	qip/
青春期	qiq/
骑车人	qir/
汽车锁	qis/
汽车团	qit/
切除术	qiu/
汽车站	qiv/
汽车网	qiw/
蕲春县	qix/
汽车业	qiy/
钱串子	qiz/
抢劫案	qja/
奇迹般	qjb/
前几次	qjc/
期间的	qjd/
丘吉尔	qje/
全家福	qjf/
清洁工	qjg/
秋交会	qjh/
去机场	qji/
清洁剂	qjj/
取景框	qjk/
请进来	qjl/
前几名	qjm/
前几年	qjn/
敲键盘	qjp/
取景器	qjq/
全家人	qjr/
前景色	qjs/
前几天	qjt/
请及时	qju/
去角质	qjv/
区纪委	qjw/
全局性	qjx/
取决于	qjy/
抢劫罪	qjz/
起开啊	qka/
浅拷贝	qkb/
趣口才	qkc/
轻快的	qkd/
区块儿	qke/
全开放	qkf/
青空光	qkg/
情况后	qkh/
缺口处	qki/
顷刻间	qkj/
期刊库	qkk/
巧克力	qkl/
情况明	qkm/
切克闹	qkn/
秦可卿	qkq/
欠款人	qkr/
七棵松	qks/
去开拓	qkt/
请开始	qku/
全靠着	qkv/
期刊网	qkw/
情况下	qkx/
却可以	qky/
且枯燥	qkz/
去了啊	qla/
起来吧	qlb/
前两次	qlc/
权利的	qld/
前脸儿	qle/
权利法	qlf/
禽流感	qlg/
轻量化	qlh/
权力场	qli/
请谅解	qlj/
前列康	qlk/
起来了	qll/
千里马	qlm/
羌历年	qln/
娶老婆	qlp/
敲了敲	qlq/
圈里人	qlr/
浅蓝色	qls/
前两天	qlt/
祁连山	qlu/
侵略者	qlv/
前六位	qlw/
请联系	qlx/
请留言	qly/
氢离子	qlz/
亲妈啊	qma/
签名版	qmb/
去买菜	qmc/
巧妙地	qmd/
起名儿	qme/
全免费	qmf/
全美国	qmg/
期满后	qmh/
气模厂	qmi/
清明节	qmj/
签名卡	qmk/
去买了	qml/
球迷们	qmm/
却没能	qmn/
汽摩配	qmp/
墙面漆	qmq/
签名人	qmr/
青霉素	qms/
青木桃	qmt/
敲门声	qmu/
敲门砖	qmv/
取名为	qmw/
全明星	qmx/
却没有	qmy/
全民族	qmz/
去哪啊	qna/
青年报	qnb/
清内存	qnc/
去年底	qnd/
去哪儿	qne/
取暖费	qnf/
青年宫	qng/
青年会	qnh/
去年初	qni/
七年级	qnj/
奇努克	qnk/
去哪里	qnl/
请你们	qnm/
七年内	qnn/
墙内篇	qnp/
取暖器	qnq/
青年人	qnr/
乔纳森	qns/
青年团	qnt/
青年时	qnu/
七年制	qnv/
区内外	qnw/
请您先	qnx/
前女友	qny/
奇女子	qnz/
求偶期	qoq/
求偶者	qov/
枪炮兵	qpb/
七盘菜	qpc/
俏皮的	qpd/
七盆儿	qpe/
秦鹏飞	qpf/
青苹果	qpg/
俏皮话	qph/
汽配城	qpi/
起拍价	qpj/
七匹狼	qpl/
全屏幕	qpm/
却偏偏	qpp/
青浦区	qpq/
强迫人	qpr/
桥牌赛	qps/
去陪他	qpt/
棋牌室	qpu/
强迫症	qpv/
汽配网	qpw/
欺骗性	qpx/
清平乐	qpy/
妻跑族	qpz/
侵权案	qqa/
请确保	qqb/
千屈菜	qqc/
轻轻地	qqd/
蛐蛐儿	qqe/
侵权法	qqf/
亲切感	qqg/
全球化	qqh/
裘千尺	qqi/
亲戚家	qqj/
清乾隆	qql/
亲戚们	qqm/
求求你	qqn/
弃权票	qqp/
请求权	qqq/
请求人	qqr/
氢氰酸	qqs/
全球通	qqt/
恰恰是	qqu/
侵权者	qqv/
千千万	qqw/
全球性	qqx/
强企业	qqy/
去人啊	qra/
全日本	qrb/
情人草	qrc/
切入点	qrd/
祁睿峰	qrf/
情人谷	qrg/
确认函	qrh/
秋日蝉	qri/
情人节	qrj/
切入口	qrk/
全人类	qrl/
亲人们	qrm/
瞧热闹	qrn/
亲日派	qrp/
确认权	qrq/
确认人	qrr/
情人锁	qrs/
侵入体	qrt/
嵌入式	qru/
全日制	qrv/
全让我	qrw/
确认信	qrx/
七日游	qry/
穷日子	qrz/
羟色胺	qsa/
去死吧	qsb/
全四册	qsc/
轻松的	qsd/
遣散费	qsf/
七色光	qsg/
七色花	qsh/
前三场	qsi/
前三甲	qsj/
起诉科	qsk/
前苏联	qsl/
前三名	qsm/
前三年	qsn/
情色片	qsp/
前三强	qsq/
清算人	qsr/
千岁岁	qss/
前三天	qst/
起诉书	qsu/
起诉状	qsv/
前三位	qsw/
曲松县	qsx/
千叟宴	qsy/
清算组	qsz/
去铁胺	qta/
桥头堡	qtb/
潜台词	qtc/
其他的	qtd/
曲檀儿	qte/
强台风	qtf/
前通过	qtg/
全天候	qth/
全脱产	qti/
钱塘江	qtj/
取土坑	qtk/
其他类	qtl/
全透明	qtm/
七天内	qtn/
乾闼婆	qtp/
请提前	qtq/
其他人	qtr/
青铜色	qts/
枪通条	qtt/
洽谈室	qtu/
请通知	qtv/
全台湾	qtw/
前提下	qtx/
祛痰药	qty/
请贴在	qtz/
枪杀案	qua/
青石板	qub/
求生存	quc/
缺少的	qud/
七十二	que/
其身份	quf/
全双工	qug/
全社会	quh/
请说出	qui/
全世界	quj/
去上课	quk/
签署了	qul/
前十名	qum/
青少年	qun/
其水平	qup/
劝睡区	quq/
起始日	qur/
七十岁	qus/
骑士团	qut/
其实是	quu/
却始终	quv/
前身为	quw/
全身心	qux/
确实有	quy/
亲手做	quz/
仇兆鳌	qva/
掐着表	qvb/
清真菜	qvc/
群众的	qvd/
区政府	qvf/
全中国	qvg/
前缀和	qvh/
球轴承	qvi/
起重机	qvj/
期中考	qvk/
倾注了	qvl/
请注明	qvm/
青壮年	qvn/
亲中派	qvp/
去追求	qvq/
圈中人	qvr/
清真寺	qvs/
去找他	qvt/
泉州市	qvu/
求职者	qvv/
全中文	qvw/
强制性	qvx/
其中有	qvy/
前阵子	qvz/
求我啊	qwa/
千万别	qwb/
钱王祠	qwc/
权威的	qwd/
去污粉	qwf/
千万个	qwg/
全委会	qwh/
清王朝	qwi/
气雾剂	qwj/
蔷薇科	qwk/
全完了	qwl/
前五名	qwm/
请问你	qwn/
青蛙趴	qwp/
轻武器	qwq/
千万人	qwr/
蔷薇色	qws/
青蛙头	qwt/
千瓦时	qwu/
期望值	qwv/
全文完	qww/
权威性	qwx/
千万元	qwy/
墙围子	qwz/
全西安	qxa/
清晰版	qxb/
七星彩	qxc/
清晰的	qxd/
起小儿	qxe/
娶媳妇	qxf/
去香港	qxg/
情绪化	qxh/
汽修厂	qxi/
气象局	qxj/
铅锌矿	qxk/
取消了	qxl/
曲线美	qxm/
期限内	qxn/
劝学篇	qxp/
栖霞区	qxq/
牵线人	qxr/
钱学森	qxs/
气象台	qxt/
钱先生	qxu/
奇侠传	qxv/
清香味	qxw/
情形下	qxx/
倾向于	qxy/
请选择	qxz/
青玉案	qya/
企业版	qyb/
去一次	qyc/
奇异的	qyd/
起眼儿	qye/
企业法	qyf/
前一个	qyg/
企业化	qyh/
牵引车	qyi/
企业家	qyj/
亲眼看	qyk/
请原谅	qyl/
亲友们	qym/
区域内	qyn/
强硬派	qyp/
青羊区	qyq/
却依然	qyr/
清一色	qys/
前一天	qyt/
潜意识	qyu/
企业中	qyv/
全英文	qyw/
区域性	qyx/
起源于	qyy/
氢原子	qyz/
却总爱	qza/
签字笔	qzb/
屈子祠	qzc/
全自动	qzd/
枪子儿	qze/
求租房	qzf/
勤杂工	qzg/
全宗号	qzh/
起早床	qzi/
前增加	qzj/
区字框	qzk/
圈子里	qzl/
亲姊妹	qzm/
却总能	qzn/
铅字盘	qzp/
前奏曲	qzq/
全自然	qzr/
浅紫色	qzs/
前总统	qzt/
却总是	qzu/
亲子装	qzv/
千字文	qzw/
青藏线	qzx/
起作用	qzy/
去走走	qzz/
仁爱礁	raj/
仁爱路	ral/
若按你	ran/
仁安羌	raq/
瑞安市	rau/
融安县	rax/
日报表	rbb/
日本菜	rbc/
日本队	rbd/
柔贝儿	rbe/
热备份	rbf/
日本国	rbg/
日本海	rbh/
认不出	rbi/
人比较	rbj/
人别哭	rbk/
忍不了	rbl/
日本妹	rbm/
仍不能	rbn/
日本片	rbp/
仁波切	rbq/
日本人	rbr/
乳白色	rbs/
人不同	rbt/
若不是	rbu/
忍不住	rbv/
容不下	rbx/
日本语	rby/
人不在	rbz/
人才啊	rca/
热刺刺	rcc/
仁慈的	rcd/
人才观	rcg/
入错行	rch/
人才处	rci/
人才局	rcj/
人才库	rck/
若错了	rcl/
人才码	rcm/
软磁盘	rcp/
如从前	rcq/
肉苁蓉	rcr/
人参赛	rcs/
阮次山	rcu/
揉搓着	rcv/
人才网	rcw/
容错性	rcx/
仍采用	rcy/
如存在	rcz/
人代表	rdb/
扔掉的	rdd/
入洞房	rdf/
热导管	rdg/
人代会	rdh/
热电厂	rdi/
让大家	rdj/
肉豆蔻	rdk/
人多了	rdl/
桡动脉	rdm/
让电脑	rdn/
热电偶	rdo/
人都怕	rdp/
熔断器	rdq/
瑞典人	rdr/
肉毒素	rds/
认得他	rdt/
人的手	rdu/
让读者	rdv/
瑞典文	rdw/
热镀锌	rdx/
热带鱼	rdy/
热电阻	rdz/
软耳朵	red/
若尔盖	reg/
任恩敬	rej/
日蛾科	rek/
软儿梨	rel/
日耳曼	rem/
壬二酸	res/
然而是	reu/
然而我	rew/
日尔乡	rex/
人防办	rfb/
仁福村	rfc/
乳房的	rfd/
日泛儿	rfe/
热敷法	rff/
润肤膏	rfg/
让风吹	rfi/
染发剂	rfj/
入风口	rfk/
润肤露	rfl/
让父母	rfm/
人粪尿	rfn/
热风枪	rfq/
润肤乳	rfr/
热付通	rft/
如发生	rfu/
柔佛州	rfv/
若发现	rfx/
乳房炎	rfy/
人贩子	rfz/
如果爱	rga/
如果不	rgb/
认个错	rgc/
日光灯	rgd/
认购额	rge/
荣国府	rgf/
若干个	rgg/
人工湖	rgh/
肉骨茶	rgi/
如果仅	rgj/
入股款	rgk/
人工林	rgl/
若干名	rgm/
如果能	rgn/
人工皮	rgp/
人格权	rgq/
若干人	rgr/
软骨素	rgs/
肉骨头	rgt/
如果说	rgu/
认购证	rgv/
扔给我	rgw/
热固性	rgx/
如果有	rgy/
如果在	rgz/
然后按	rha/
然后把	rhb/
然后才	rhc/
任何的	rhd/
入伙儿	rhe/
入会费	rhf/
如何改	rhg/
热乎乎	rhh/
熔化成	rhi/
然后就	rhj/
入海口	rhk/
融合了	rhl/
入户门	rhm/
然后呢	rhn/
润喉片	rhp/
如何去	rhq/
任何人	rhr/
乳黄色	rhs/
润喉糖	rht/
如何使	rhu/
润滑脂	rhv/
如何为	rhw/
如何写	rhx/
润滑油	rhy/
然后再	rhz/
惹尘埃	ria/
日程表	rib/
热成层	ric/
热忱的	rid/
入场费	rif/
润唇膏	rig/
入朝后	rih/
日出场	rii/
日成交	rij/
入出库	rik/
热处理	ril/
入川码	rim/
日驰尼	rin/
入场券	riq/
人吃人	rir/
日常帖	rit/
荣成市	riu/
热潮中	riv/
荣成湾	riw/
若出现	rix/
仍处于	riy/
软件包	rjb/
软件层	rjc/
儒家的	rjd/
韧劲儿	rje/
让肌肤	rjf/
热加工	rjg/
软交换	rjh/
乳胶厂	rji/
让姐姐	rjj/
软件库	rjk/
容积率	rjl/
肉夹馍	rjm/
软胶囊	rjn/
软键盘	rjp/
乳胶漆	rjq/
人挤人	rjr/
人教司	rjs/
阮经天	rjt/
人家说	rju/
让记者	rjv/
认监委	rjw/
溶剂型	rjx/
软件园	rjy/
人尖子	rjz/
让开吧	rkb/
认可的	rkd/
热咖啡	rkf/
软口盖	rkg/
让客户	rkh/
入口处	rki/
如会计	rkj/
绕口令	rkl/
惹口面	rkm/
仍可能	rkn/
人看人	rkr/
热扩散	rks/
热炕头	rkt/
人口数	rku/
认可者	rkv/
软科学	rkx/
仍可以	rky/
日喀则	rkz/
扔了啊	rla/
扰流板	rlb/
燃料舱	rlc/
热烈的	rld/
如来佛	rlf/
日了狗	rlg/
日落黄	rlh/
人力车	rli/
软链接	rlj/
燃料库	rlk/
人流量	rll/
热冷面	rlm/
日历年	rln/
容量瓶	rlp/
扰流器	rlq/
日历日	rlr/
染了色	rls/
人来说	rlu/
人流中	rlv/
容量为	rlw/
人类学	rlx/
燃料油	rly/
惹娄子	rlz/
人命案	rma/
人民币	rmb/
人名册	rmc/
人民党	rmd/
肉末儿	rme/
惹麻烦	rmf/
让美国	rmg/
如梦幻	rmh/
热门车	rmi/
热卖价	rmj/
人民路	rml/
软绵绵	rmm/
乳糜尿	rmn/
入门篇	rmp/
任免权	rmq/
软木塞	rms/
让媒体	rmt/
任命书	rmu/
入门者	rmv/
人民网	rmw/
热敏性	rmx/
若没有	rmy/
人马座	rmz/
让那边	rnb/
忍耐的	rnd/
让你飞	rnf/
让那个	rng/
让你喊	rnh/
热奶茶	rni/
热闹劲	rnj/
让你看	rnk/
热闹了	rnl/
让你们	rnm/
任你拿	rnn/
让你跑	rnp/
让女人	rnr/
热耐思	rns/
任你挑	rnt/
揉捏着	rnv/
日内瓦	rnw/
汝南县	rnx/
热那亚	rny/
让你在	rnz/
人偶戏	rox/
韧皮部	rpb/
如瀑地	rpd/
肉片儿	rpe/
人品好	rph/
乳品厂	rpi/
日牌价	rpj/
人皮脸	rpl/
饶平如	rpr/
肉蒲团	rpt/
软盘上	rpu/
热膨胀	rpv/
饶平县	rpx/
人气榜	rqb/
融洽的	rqd/
瑞切尔	rqe/
若侵犯	rqf/
让全国	rqg/
绒球花	rqh/
让汽车	rqi/
燃气具	rqj/
人情款	rqk/
热起来	rql/
容器内	rqn/
热气球	rqq/
乳清酸	rqs/
让其他	rqt/
任丘市	rqu/
人群中	rqv/
人情味	rqw/
若羌县	rqx/
让企业	rqy/
燃气灶	rqz/
人人爱	rra/
让日本	rrb/
让人猜	rrc/
柔弱的	rrd/
认人儿	rre/
惹人烦	rrf/
荣辱观	rrg/
仍然会	rrh/
仍如常	rri/
热熔胶	rrj/
揉揉看	rrk/
人人乐	rrl/
让人们	rrm/
任溶溶	rrr/
让人挺	rrt/
仍然是	rru/
嚷嚷着	rrv/
软任务	rrw/
柔韧性	rrx/
惹人厌	rry/
仍然在	rrz/
瑞思拜	rsb/
染色法	rsf/
乳酸钙	rsg/
染色厂	rsi/
乳酸菌	rsj/
茹丝葵	rsk/
认死理	rsl/
肉丝面	rsm/
乳酸钠	rsn/
若斯潘	rsp/
热死人	rsr/
软酥酥	rss/
染色体	rst/
燃素说	rsu/
染色质	rsv/
人死亡	rsw/
热塑性	rsx/
让所有	rsy/
若他不	rtb/
人太多	rtd/
人头费	rtf/
认同感	rtg/
软通货	rth/
乳糖醇	rti/
乳头肌	rtj/
软条款	rtk/
让他来	rtl/
让他们	rtm/
人体内	rtn/
热天气	rtq/
人托人	rtr/
人胎素	rts/
任天堂	rtt/
肉体上	rtu/
乳头状	rtv/
让台湾	rtw/
壤塘县	rtx/
乳突炎	rty/
认识啊	rua/
人事部	rub/
让身材	ruc/
认识到	rud/
惹是非	ruf/
人生观	rug/
入世后	ruh/
人事处	rui/
人事局	ruj/
人事科	ruk/
认识了	rul/
认识吗	rum/
认识你	run/
热水藕	ruo/
肉食品	rup/
热水器	ruq/
让世人	rur/
热身赛	rus/
人事厅	rut/
如是说	ruu/
燃烧着	ruv/
妊娠纹	ruw/
榕树下	rux/
人数约	ruy/
热水澡	ruz/
热轧板	rvb/
肉中刺	rvc/
认真的	rvd/
让政府	rvf/
让中国	rvg/
如之何	rvh/
人之初	rvi/
热轧卷	rvj/
软着陆	rvl/
认证码	rvm/
热着呢	rvn/
乳制品	rvp/
润州区	rvq/
绕指柔	rvr/
软脂酸	rvs/
日之塔	rvt/
日照市	rvu/
让这种	rvv/
乳状物	rvw/
让这些	rvx/
热衷于	rvy/
人渣滓	rvz/
人武部	rwb/
任务层	rwc/
人为的	rwd/
入味儿	rwe/
仍无法	rwf/
让我哥	rwg/
让我回	rwh/
任务池	rwi/
让玩家	rwj/
让我看	rwk/
任务栏	rwl/
让我们	rwm/
让我拿	rwn/
热瓦普	rwp/
让我去	rwq/
热污染	rwr/
让我死	rws/
认为他	rwt/
认为是	rwu/
任务重	rwv/
让我无	rww/
任我行	rwx/
让位于	rwy/
让我再	rwz/
乳腺癌	rxa/
柔性版	rxb/
荣星村	rxc/
人行道	rxd/
肉馅儿	rxe/
日向枫	rxf/
软下疳	rxg/
人性化	rxh/
热心肠	rxi/
绕线机	rxj/
入学考	rxk/
入学率	rxl/
人性美	rxm/
热性能	rxn/
任贤齐	rxq/
热心人	rxr/
人相似	rxs/
如下图	rxt/
让学生	rxu/
入选者	rxv/
日新闻	rxw/
让学校	rxx/
仍需要	rxy/
人行走	rxz/
容易把	ryb/
日用瓷	ryc/
如遇到	ryd/
如意儿	rye/
热压釜	ryf/
让一个	ryg/
让用户	ryh/
人与车	ryi/
软硬件	ryj/
如意卡	ryk/
容易了	ryl/
容易吗	rym/
肉用牛	ryn/
日用品	ryp/
任意球	ryq/
人与人	ryr/
瑞岩寺	rys/
日月潭	ryt/
燃油税	ryu/
肉芽肿	ryv/
人妖王	ryw/
让一些	ryx/
如有意	ryy/
肉圆子	ryz/
人造板	rzb/
人再多	rzd/
容祖儿	rze/
人字缝	rzf/
人造革	rzg/
人组合	rzh/
让自己	rzj/
融资款	rzk/
日子里	rzl/
人造棉	rzm/
孺子牛	rzn/
人字旁	rzp/
融资券	rzq/
人造人	rzr/
人造丝	rzs/
任总统	rzt/
人造石	rzu/
软组织	rzv/
任子威	rzw/
人在线	rzx/
饶宗颐	rzy/
阮宗泽	rzz/
遂安伯	sab/
苏垵村	sac/
三爱富	saf/
苏澳港	sag/
死傲娇	saj/
三暗刻	sak/
宋蔼龄	sal/
色氨酸	sas/
塞奥沙	sau/
桑阿镇	sav/
澌岸乡	sax/
三阿姨	say/
随便啊	sba/
随便吧	sbb/
酸白菜	sbc/
斯巴达	sbd/
碎步儿	sbe/
三部分	sbf/
三百个	sbg/
所包含	sbh/
随便吃	sbi/
三八节	sbj/
斯波克	sbk/
斯巴鲁	sbl/
三部门	sbm/
虽不能	sbn/
赛比欧	sbo/
三百篇	sbp/
三部曲	sbq/
三百人	sbr/
算不算	sbs/
所不同	sbt/
算不上	sbu/
随便找	sbv/
所包围	sbw/
所必需	sbx/
三百元	sby/
三步走	sbz/
素菜包	scb/
色彩层	scc/
三寸丁	scd/
三次方	scf/
色彩感	scg/
酸催化	sch/
酸菜厂	sci/
搜藏家	scj/
素材库	sck/
三层楼	scl/
三次幂	scm/
酸菜牛	scn/
色彩屏	scp/
锁存器	scq/
送错人	scr/
桑蚕丝	scs/
酸菜汤	sct/
三寸舌	scu/
莎草纸	scv/
搜才网	scw/
色彩学	scx/
所采用	scy/
骚操作	scz/
三都澳	sda/
所代表	sdb/
三等舱	sdc/
锁定的	sdd/
所得额	sde/
斯蒂芬	sdf/
三等功	sdg/
苏丹红	sdh/
三道茶	sdi/
三等奖	sdj/
速度快	sdk/
斯大林	sdl/
萨达姆	sdm/
隧道南	sdn/
苏东坡	sdp/
散弹枪	sdq/
送达人	sdr/
死的死	sds/
死对头	sdt/
所得税	sdu/
三点钟	sdv/
赛迪网	sdw/
私底下	sdx/
所对应	sdy/
锁定在	sdz/
塞尔比	seb/
三二村	sec/
塞尔达	sed/
寺儿沟	seg/
塞尔赫	seh/
索尔城	sei/
塞尔吉	sej/
丝尔康	sek/
塞尔伦	sel/
萨尔玛	sem/
孙二娘	sen/
三恶趣	seq/
索额图	set/
萨尔州	sev/
斯俄乡	sex/
三二一	sey/
宋恩子	sez/
司法部	sfb/
私房菜	sfc/
三分地	sfd/
送分儿	sfe/
随风飞	sff/
所覆盖	sfg/
绥芬河	sfh/
散发出	sfi/
司法局	sfj/
送风口	sfk/
算法类	sfl/
三方面	sfm/
随风飘	sfp/
三分球	sfq/
孙夫人	sfr/
三法司	sfs/
司法厅	sft/
所发生	sfu/
散发着	sfv/
私服网	sfw/
四方形	sfx/
索菲亚	sfy/
随份子	sfz/
所公布	sgb/
三国策	sgc/
所规定	sgd/
笋干儿	sge/
三姑夫	sgf/
死光光	sgg/
桑干河	sgh/
三宫椿	sgi/
三个键	sgj/
三公开	sgk/
苏格兰	sgl/
塑钢门	sgm/
送给你	sgn/
算个屁	sgp/
送过去	sgq/
三个人	sgr/
三公司	sgs/
送给他	sgt/
三国杀	sgu/
三国志	sgv/
送给我	sgw/
萨嘎县	sgx/
三个月	sgy/
四个字	sgz/
丝毫不	shb/
孙河村	shc/
所获得	shd/
三孩儿	she/
送货费	shf/
送红股	shg/
松花湖	shh/
散货船	shi/
松花江	shj/
送贺卡	shk/
撒哈拉	shl/
三化螟	shm/
三合泥	shn/
损耗品	shp/
宋慧乔	shq/
送货人	shr/
四环素	shs/
死胡同	sht/
似乎是	shu/
损害者	shv/
搜狐网	shw/
三号线	shx/
似乎有	shy/
宋徽宗	shz/
速成班	sib/
三叉村	sic/
四川队	sid/
孙承恩	sie/
赛车服	sif/
送出国	sig/
四川话	sih/
四冲程	sii/
三叉戟	sij/
三岔口	sik/
洒出来	sil/
三重门	sim/
赛车皮	sip/
送出去	siq/
四川人	sir/
四乘四	sis/
三重天	sit/
四川省	siu/
撕扯着	siv/
所出现	six/
宋楚瑜	siy/
四重奏	siz/
苏教版	sjb/
私家菜	sjc/
三季度	sjd/
索杰恩	sje/
三间房	sjf/
三极管	sjg/
三句话	sjh/
私家车	sji/
三脚架	sjj/
三剑客	sjk/
斯佳丽	sjl/
三姐妹	sjm/
斯金纳	sjn/
三级片	sjp/
松江区	sjq/
宋教仁	sjr/
三基色	sjs/
三件套	sjt/
所接受	sju/
三角洲	sjv/
孙家湾	sjw/
三角形	sjx/
所具有	sjy/
四君子	sjz/
三孔鼻	skb/
三坑村	skc/
斯柯达	skd/
四块二	ske/
所开发	skf/
萨克管	skg/
所困惑	skh/
三卡池	ski/
散客价	skj/
松垮垮	skk/
撕开了	skl/
三康庙	skm/
所苦恼	skn/
四块魮	skp/
松口气	skq/
所困扰	skr/
萨克斯	sks/
思考题	skt/
三棵树	sku/
思考着	skv/
撒克逊	skx/
斯利安	sla/
司令部	slb/
缩略词	slc/
塑料袋	sld/
三轮儿	sle/
森林法	slf/
司令官	slg/
三里河	slh/
三轮车	sli/
四六级	slj/
四六开	slk/
森林里	sll/
所罗门	slm/
苏里南	sln/
塑料瓶	slp/
孙立群	slq/
苏联人	slr/
索罗斯	sls/
缩略图	slt/
苏黎世	slu/
耸立着	slv/
送礼物	slw/
三两下	slx/
司令员	sly/
散落在	slz/
司米安	sma/
三米板	smb/
三民村	smc/
三摩地	smd/
三毛儿	sme/
三面翻	smf/
司马光	smg/
赛马会	smh/
赛马场	smi/
萨满教	smj/
司门口	smk/
所面临	sml/
色眯眯	smm/
司马南	smn/
司马丕	smp/
思明区	smq/
色目人	smr/
萨默斯	sms/
酸梅汤	smt/
三明市	smu/
三明治	smv/
三毛五	smw/
三门峡	smx/
扫描仪	smy/
宋木子	smz/
随你便	snb/
苏内村	snc/
萨内蒂	snd/
孙女儿	sne/
桑拿房	snf/
所能够	sng/
三年后	snh/
送奶茶	sni/
三年级	snj/
斯诺克	snk/
三年来	snl/
随你们	snm/
三年内	snn/
斯内普	snp/
三年前	snq/
酸牛乳	snr/
萨诺斯	sns/
桑拿天	snt/
遂宁市	snu/
三年制	snv/
三娘湾	snw/
睢宁县	snx/
桑拿浴	sny/
三娘子	snz/
三欧村	soc/
松耦合	soh/
苏欧司	sos/
森鸥外	sow/
索赔案	spa/
桑坡村	spc/
桑普多	spd/
三盆儿	spe/
色谱法	spf/
酸苹果	spg/
娑婆诃	sph/
丝盘虫	spi/
伞铺街	spj/
斯派克	spk/
四平路	spl/
三匹马	spm/
三陪女	spn/
孙婆婆	spp/
索赔权	spq/
索赔人	spr/
斯潘塞	sps/
酸葡萄	spt/
四平市	spu/
桑皮纸	spv/
斯派维	spw/
松潘县	spx/
色谱仪	spy/
三拍子	spz/
送秋波	sqb/
森七菜	sqc/
所取得	sqd/
撒切尔	sqe/
三七分	sqf/
三千个	sqg/
索取号	sqh/
四驱车	sqi/
死全家	sqj/
色情狂	sqk/
宋庆龄	sql/
萨其马	sqm/
三千年	sqn/
色情片	sqp/
死翘翘	sqq/
三千人	sqr/
四强赛	sqs/
三清潭	sqt/
宿迁市	squ/
粟丘疹	sqv/
三千万	sqw/
宿迁县	sqx/
三千元	sqy/
三七仔	sqz/
三热爱	sra/
四人帮	srb/
三人餐	src/
私人的	srd/
桑葚儿	sre/
孙若丰	srf/
散热膏	srg/
虽然会	srh/
速溶茶	sri/
三人间	srj/
散热孔	srk/
死人了	srl/
四人门	srm/
虽然能	srn/
散热片	srp/
散热器	srq/
虽然仍	srr/
四人赛	srs/
散热贴	srt/
虽然是	sru/
虽然只	srv/
孙若微	srw/
三人行	srx/
虽然有	sry/
虽然在	srz/
诉讼案	ssa/
散散步	ssb/
搜索词	ssc/
色色的	ssd/
四四二	sse/
诉讼费	ssf/
三四个	ssg/
宋思衡	ssh/
缫丝厂	ssi/
耸耸肩	ssj/
算算看	ssk/
搜索栏	ssl/
孙思邈	ssm/
三四年	ssn/
三四排	ssp/
搜索器	ssq/
酸酸乳	ssr/
三四岁	sss/
三四天	sst/
三四十	ssu/
诉讼中	ssv/
三四五	ssw/
散散心	ssx/
搔搔痒	ssy/
三同步	stb/
司徒村	stc/
桑坦德	std/
松塔儿	ste/
斯坦福	stf/
所提供	stg/
三天后	sth/
所推出	sti/
三头肌	stj/
斯塔克	stk/
斯坦利	stl/
斯塔姆	stm/
桑塔纳	stn/
搔头皮	stp/
三天前	stq/
三体人	str/
斯通斯	sts/
四条腿	stt/
三同时	stu/
司徒钟	stv/
三套娃	stw/
三条线	stx/
所特有	sty/
宋太祖	stz/
算啥啊	sua/
四十八	sub/
三十层	suc/
三十多	sud/
三十二	sue/
三十分	suf/
三十个	sug/
私生活	suh/
所生产	sui/
所涉及	suj/
随时可	suk/
丧失了	sul/
算什么	sum/
三十年	sun/
速射炮	sup/
所申请	suq/
三十日	sur/
三十岁	sus/
随身听	sut/
虽说是	suu/
诉说着	suv/
三十五	suw/
孙尚香	sux/
所使用	suy/
私生子	suz/
色织布	svb/
扫帚菜	svc/
酸中毒	svd/
损招儿	sve/
送祝福	svf/
孙志刚	svg/
苏州河	svh/
所支持	svi/
碎纸机	svj/
丝竹空	svk/
锁住了	svl/
酸枝木	svm/
三周年	svn/
丝织品	svp/
死之前	svq/
三种人	svr/
四周跳	svt/
苏州市	svu/
三张纸	svv/
四周围	svw/
泗州戏	svx/
诉诸于	svy/
宋真宗	svz/
苏维埃	swa/
四五百	swb/
四五次	swc/
隋文帝	swd/
骚味儿	swe/
所无法	swf/
四五个	swg/
三尾惠	swh/
色王朝	swi/
散文集	swj/
孙悟空	swk/
死亡率	swl/
四五米	swm/
送温暖	swn/
三五炮	swp/
四五千	swq/
三万人	swr/
四五岁	sws/
三五天	swt/
散文诗	swu/
死亡者	swv/
四万万	sww/
俗文学	swx/
三万元	swy/
送物资	swz/
苏小安	sxa/
三厢版	sxb/
缩写词	sxc/
三兄弟	sxd/
素馅儿	sxe/
死刑犯	sxf/
三邪关	sxg/
死循环	sxh/
三厢车	sxi/
四星级	sxj/
随心看	sxk/
缩小了	sxl/
苏小妹	sxm/
司小念	sxn/
松下牌	sxp/
随想曲	sxq/
送信人	sxr/
三希堂	sxt/
思想上	sxu/
思想者	sxv/
所希望	sxw/
思想性	sxx/
所吸引	sxy/
所选择	sxz/
苏永安	sya/
损益表	syb/
三叶草	syc/
随意的	syd/
宋允儿	sye/
三月份	syf/
所有格	syg/
所以很	syh/
酥油茶	syi/
所以就	syj/
苏永康	syk/
岁月里	syl/
孙毓敏	sym/
所以能	syn/
苏有朋	syp/
所有权	syq/
所有人	syr/
三月三	sys/
四月天	syt/
所以说	syu/
所有者	syv/
所以我	syw/
随意性	syx/
所拥有	syy/
所以在	syz/
三总部	szb/
四字词	szc/
所在地	szd/
散座儿	sze/
丧葬费	szf/
所在国	szg/
嗓子好	szh/
所造成	szi/
三字经	szj/
三唑仑	szl/
臊子面	szm/
算在内	szn/
随葬品	szp/
三座桥	szq/
酸枣仁	szr/
松子酥	szs/
三唑酮	szt/
松滋市	szu/
塑造着	szv/
宋子文	szw/
梭子蟹	szx/
宋祖英	szy/
所在组	szz/
田艾板	tab/
团安村	tac/
泰安道	tad/
同案犯	taf/
童安格	tag/
特奥会	tah/
探案集	taj/
太拗口	tak/
忒矮了	tal/
天安门	tam/
他爱你	tan/
同安区	taq/
提案人	tar/
提艾斯	tas/
他爱她	tat/
泰安市	tau/
提案者	tav/
台安县	tax/
太安鱼	tay/
特案组	taz/
特保案	tba/
特别版	tbb/
挺不错	tbc/
听不懂	tbd/
贴本儿	tbe/
特别法	tbf/
逃不过	tbg/
他不会	tbh/
逃不出	tbi/
它不仅	tbj/
太不可	tbk/
通报了	tbl/
同胞们	tbm/
他把你	tbn/
托比欧	tbo/
天不怕	tbp/
提不起	tbq/
投标人	tbr/
同步锁	tbs/
逃不脱	tbt/
特别是	tbu/
特别重	tbv/
淘宝网	tbw/
他不想	tbx/
特别要	tby/
特别在	tbz/
他从不	tcb/
天苍苍	tcc/
铁蚕豆	tcd/
挑错儿	tce/
体操房	tcf/
探测狗	tcg/
统促会	tch/
陶瓷厂	tci/
他曾经	tcj/
体操课	tck/
太糙了	tcl/
太聪明	tcm/
偷菜呢	tcn/
陶瓷片	tcp/
探测器	tcq/
太残忍	tcr/
体操赛	tcs/
探测头	tct/
太仓市	tcu/
陶瓷砖	tcv/
他从未	tcw/
他从小	tcx/
探测仪	tcy/
他曾在	tcz/
听到啊	tda/
铁道部	tdb/
头等舱	tdc/
听得懂	tdd/
铜斗儿	tde/
天都峰	tdf/
听的歌	tdg/
通电话	tdh/
推断出	tdi/
天地间	tdj/
通道口	tdk/
太多了	tdl/
他的美	tdm/
土豆泥	tdn/
替代品	tdp/
他的钱	tdq/
太多人	tdr/
太嘚瑟	tds/
他的腿	tdt/
特点是	tdu/
他带着	tdv/
替代物	tdw/
谈对象	tdx/
特点与	tdy/
腿肚子	tdz/
天鹅堡	teb/
兔耳草	tec/
兔耳朵	ted/
吐尔根	teg/
天鹅湖	teh/
铁二局	tej/
图尔克	tek/
太饿了	tel/
通俄门	tem/
塔尔坡	tep/
土耳其	teq/
天鹅绒	ter/
托儿所	tes/
梯恩梯	tet/
掏耳勺	teu/
台儿庄	tev/
吐尔逊	tex/
兔儿爷	tey/
他儿子	tez/
太方便	tfb/
太讽刺	tfc/
颓废的	tfd/
他仿佛	tff/
托付给	tfg/
特服号	tfh/
通风处	tfi/
通风机	tfj/
通风口	tfk/
投放量	tfl/
同分母	tfm/
特烦恼	tfn/
颓废派	tfp/
通风器	tfq/
太夫人	tfr/
铜佛寺	tfs/
太妃糖	tft/
头发上	tfu/
停放着	tfv/
铁饭碗	tfw/
突发性	tfx/
谭富英	tfy/
太复杂	tfz/
台港澳	tga/
团干部	tgb/
他干脆	tgc/
提高到	tgd/
泰戈尔	tge/
提供方	tgf/
提供给	tgg/
推广会	tgh/
太古城	tgi/
他赶紧	tgj/
同甘苦	tgk/
提供了	tgl/
太过敏	tgm/
退给你	tgn/
谈个屁	tgp/
塘沽区	tgq/
托管人	tgr/
他告诉	tgs/
剃光头	tgt/
提供商	tgu/
提供者	tgv/
团购网	tgw/
提高性	tgx/
铁观音	tgy/
唐高宗	tgz/
桃花庵	tha/
天花板	thb/
桃花村	thc/
体会到	thd/
甜活儿	the/
通话费	thf/
碳化硅	thg/
退换货	thh/
替换成	thi/
铁合金	thj/
陶宏开	thk/
太好了	thl/
同行们	thm/
它还能	thn/
炭火盆	thp/
天河区	thq/
他忽然	thr/
土黄色	ths/
他和她	tht/
他还说	thu/
谈话中	thv/
替换为	thw/
桃花雪	thx/
同行业	thy/
他还在	thz/
唐长安	tia/
脱产班	tib/
弹出层	tic/
突出的	tid/
弹窗二	tie/
停车费	tif/
太成功	tig/
退出后	tih/
停车场	tii/
填充剂	tij/
天川空	tik/
提出了	til/
铜车马	tim/
停车难	tin/
天秤偶	tio/
唐菖蒲	tip/
逃出去	tiq/
他承认	tir/
填充色	tis/
填充题	tit/
通常是	tiu/
他穿着	tiv/
停车位	tiw/
郯城县	tix/
通常由	tiy/
天秤座	tiz/
田家庵	tja/
统计表	tjb/
特价菜	tjc/
推荐的	tjd/
替角儿	tje/
调节阀	tjf/
推荐给	tjg/
推介会	tjh/
田径场	tji/
添加剂	tjj/
塔吉克	tjk/
汤加丽	tjl/
堂姐妹	tjm/
糖精钠	tjn/
停机坪	tjp/
太极拳	tjq/
推荐人	tjr/
统计司	tjs/
太极图	tjt/
天津市	tju/
提交者	tjv/
同价位	tjw/
条件下	tjx/
它具有	tjy/
土家族	tjz/
挺可爱	tka/
坦克兵	tkb/
讨口彩	tkc/
痛苦的	tkd/
糖块儿	tke/
太空服	tkf/
痛苦弓	tkg/
特困户	tkh/
太空船	tki/
提款机	tkj/
提款卡	tkk/
拓宽了	tkl/
太空棉	tkm/
他可能	tkn/
特靠谱	tkp/
探矿权	tkq/
太空人	tkr/
特克斯	tks/
填空题	tkt/
铁矿石	tku/
停靠站	tkv/
太可恶	tkw/
天空下	tkx/
他可以	tky/
停靠在	tkz/
谈恋爱	tla/
头两步	tlb/
天籁村	tlc/
贪婪的	tld/
趿拉儿	tle/
吐鲁番	tlf/
讨论稿	tlg/
讨论会	tlh/
透漏出	tli/
拖拉机	tlj/
挺凉快	tlk/
天亮了	tll/
塔里木	tlm/
陀罗尼	tln/
特里普	tlp/
讨论区	tlq/
同龄人	tlr/
天蓝色	tls/
推了推	tlt/
他脸上	tlu/
凸轮轴	tlv/
铜锣湾	tlw/
同类型	tlx/
特洛伊	tly/
讨论组	tlz/
贴膜啊	tma/
他们把	tmb/
田面村	tmc/
他们的	tmd/
帖木儿	tme/
添麻烦	tmf/
同美国	tmg/
透明化	tmh/
填埋场	tmi/
他们将	tmj/
天猫卡	tmk/
他们俩	tml/
甜蜜蜜	tmm/
他们呢	tmn/
特没谱	tmp/
提名权	tmq/
提名人	tmr/
托马斯	tms/
土默特	tmt/
他们是	tmu/
铁木真	tmv/
天马唯	tmw/
汤姆逊	tmx/
他们有	tmy/
土妹子	tmz/
糖尿病	tnb/
挺能藏	tnc/
他娘的	tnd/
他女儿	tne/
台南府	tnf/
太难搞	tng/
挺暖和	tnh/
太能吹	tni/
同年级	tnj/
他宁可	tnk/
太难了	tnl/
推你们	tnm/
太奶奶	tnn/
太年轻	tnq/
台南人	tnr/
突尼斯	tns/
太逆天	tnt/
童年时	tnu/
头脑中	tnv/
坛南湾	tnw/
田纳西	tnx/
他宁愿	tny/
铁娘子	tnz/
糖藕片	top/
甜藕粥	tov/
童偶熊	tox/
挺拼啊	tpa/
图片吧	tpb/
太平村	tpc/
突破点	tpd/
贴谱儿	tpe/
通配符	tpf/
调皮鬼	tpg/
藤浦惠	tph/
调配出	tpi/
太平军	tpj/
突破口	tpk/
突破了	tpl/
太平门	tpm/
太平鸟	tpn/
弹琵琶	tpp/
投票权	tpq/
投票日	tpr/
汤普森	tps/
拓扑图	tpt/
图片数	tpu/
谈判中	tpv/
太平王	tpw/
突破性	tpx/
太平洋	tpy/
偷盘子	tpz/
退群吧	tqb/
烫青菜	tqc/
他强调	tqd/
听曲儿	tqe/
提取法	tqf/
提起过	tqg/
投洽会	tqh/
听清楚	tqi/
探亲假	tqj/
通气孔	tqk/
听起来	tql/
脱氢酶	tqm/
同情你	tqn/
提前批	tqp/
天桥区	tqq/
天气热	tqr/
天青色	tqs/
抬起头	tqt/
同期声	tqu/
通勤装	tqv/
提取物	tqw/
同情心	tqx/
提取液	tqy/
他亲自	tqz/
投入比	trb/
太仁慈	trc/
突然的	trd/
糖人儿	tre/
谭人凤	trf/
特任官	trg/
倘若会	trh/
天润城	tri/
突然间	trj/
天然矿	trk/
天然林	trl/
同仁们	trm/
倘若能	trn/
他人品	trp/
天然气	trq/
太让人	trr/
天然色	trs/
同仁堂	trt/
谈人生	tru/
土壤中	trv/
他认为	trw/
突然性	trx/
太容易	try/
投融资	trz/
碳酸铵	tsa/
调色板	tsb/
特色菜	tsc/
褪色的	tsd/
唐赛儿	tse/
图算法	tsf/
碳酸钙	tsg/
他似乎	tsh/
太塞车	tsi/
铁三角	tsj/
托斯卡	tsk/
太色了	tsl/
碳酸镁	tsm/
碳酸钠	tsn/
调色盘	tsp/
调速器	tsq/
它虽然	tsr/
甜丝丝	tss/
谭嗣同	tst/
同宿舍	tsu/
探索者	tsv/
铁丝网	tsw/
探索性	tsx/
碳酸盐	tsy/
唐三藏	tsz/
头疼啊	tta/
听听吧	ttb/
团体操	ttc/
偷偷地	ttd/
褪套儿	tte/
团头鲂	ttf/
汤头歌	ttg/
天天好	tth/
土特产	tti/
推土机	ttj/
挺痛苦	ttk/
吞吐量	ttl/
替他们	ttm/
天堂鸟	ttn/
团体票	ttp/
贴图区	ttq/
他突然	ttr/
淘汰赛	tts/
通天塔	ttt/
天台山	ttu/
团团转	ttv/
踢踏舞	ttw/
通透性	ttx/
天通苑	tty/
唐太宗	ttz/
跳上岸	tua/
同时被	tub/
唐师曾	tuc/
提升到	tud/
挑事儿	tue/
提示符	tuf/
图书馆	tug/
他身后	tuh/
图书城	tui/
台式机	tuj/
提示框	tuk/
踏上了	tul/
同事们	tum/
听说你	tun/
铁山坪	tup/
听上去	tuq/
他上任	tur/
跳水赛	tus/
透视图	tut/
他身上	tuu/
他甚至	tuv/
团市委	tuw/
特殊性	tux/
同时也	tuy/
汰石子	tuz/
团支部	tvb/
土政策	tvc/
同志的	tvd/
投注额	tve/
天柱峰	tvf/
同中国	tvg/
调整后	tvh/
他指出	tvi/
天主教	tvj/
天竺葵	tvk/
停止了	tvl/
同志们	tvm/
通知您	tvn/
糖粥藕	tvo/
铁制品	tvp/
通州区	tvq/
土著人	tvr/
挑战赛	tvs/
他整天	tvt/
通知书	tvu/
统治者	tvv/
通知我	tvw/
挑战性	tvx/
他终于	tvy/
同志在	tvz/
贪污案	twa/
图文版	twb/
同温层	twc/
太无敌	twd/
贪玩儿	twe/
体位法	twf/
滕王阁	twg/
台湾猴	twh/
跳舞场	twi/
头文件	twj/
图文框	twk/
调味料	twl/
同我们	twm/
台湾牛	twn/
调味品	twp/
摊位前	twq/
台湾人	twr/
同位素	tws/
天文台	twt/
台湾省	twu/
提问者	twv/
他问我	tww/
天文学	twx/
同位语	twy/
贪污罪	twz/
同学啊	txa/
通信兵	txb/
田心村	txc/
剃须刀	txd/
听信儿	txe/
通行费	txf/
提刑官	txg/
他喜欢	txh/
体现出	txi/
退休金	txj/
太辛苦	txk/
体现了	txl/
同学们	txm/
提醒您	txn/
天仙配	txp/
特许权	txq/
贴心人	txr/
土行孙	txs/
弹性体	txt/
通讯社	txu/
通行证	txv/
他希望	txw/
他相信	txx/
通讯员	txy/
体现在	txz/
同意案	tya/
他一边	tyb/
头一次	tyc/
统一的	tyd/
痰盂儿	tye/
脱衣服	tyf/
同一个	tyg/
同意后	tyh/
体育场	tyi/
投影机	tyj/
体育课	tyk/
同意了	tyl/
陶渊明	tym/
太阳能	tyn/
投一票	typ/
它要求	tyq/
托运人	tyr/
太阳伞	tys/
谈一谈	tyt/
同样是	tyu/
同一种	tyv/
天音唯	tyw/
特异性	tyx/
他一眼	tyy/
同样在	tyz/
陶子安	tza/
投资部	tzb/
田字草	tzc/
他走到	tzd/
投资额	tze/
投资方	tzf/
投资国	tzg/
太在乎	tzh/
屠宰场	tzi/
他自己	tzj/
投资款	tzk/
他走了	tzl/
他做梦	tzm/
太子奶	tzn/
桐梓坡	tzp/
踢足球	tzq/
投资人	tzr/
太自私	tzs/
兔子头	tzt/
投资商	tzu/
投资者	tzv/
投资网	tzw/
投资性	tzx/
投资于	tzy/
陶醉在	tzz/
上岸村	uac/
圣安德	uad/
圣艾芙	uaf/
上岸后	uah/
顺安街	uaj/
上岸来	ual/
水按摩	uam/
说爱你	uan/
涉案人	uar/
上岸通	uat/
山艾树	uau/
是按照	uav/
说爱我	uaw/
水隘乡	uax/
石傲玉	uay/
山案座	uaz/
上班啊	uba/
申报表	ubb/
十八层	ubc/
失败的	ubd/
双棒儿	ube/
商标法	ubf/
数百个	ubg/
世博会	ubh/
说不出	ubi/
商标局	ubj/
升本科	ubk/
受不了	ubl/
商标名	ubm/
上半年	ubn/
十八盘	ubp/
商标权	ubq/
是必然	ubr/
十八岁	ubs/
双胞胎	ubt/
是不是	ubu/
殊不知	ubv/
数百万	ubw/
时必须	ubx/
世博园	uby/
上班族	ubz/
收藏啊	uca/
收藏版	ucb/
深层次	ucc/
受挫的	ucd/
手彩儿	uce/
十次方	ucf/
山慈姑	ucg/
水彩画	uch/
石材厂	uci/
收藏夹	ucj/
闪存卡	uck/
收藏了	ucl/
神策门	ucm/
守财奴	ucn/
收藏哦	uco/
收藏品	ucp/
生存期	ucq/
是脆弱	ucr/
上厕所	ucs/
蔬菜汤	uct/
闪存式	ucu/
收藏者	ucv/
沈从文	ucw/
上蔡县	ucx/
使参与	ucy/
啥操作	ucz/
食道癌	uda/
上等兵	udb/
上档次	udc/
适当的	udd/
闪道儿	ude/
士大夫	udf/
十多个	udg/
收到后	udh/
山地车	udi/
圣诞节	udj/
上党课	udk/
受到了	udl/
是多么	udm/
十多年	udn/
是的哦	udo/
耍大牌	udp/
说得清	udq/
山东人	udr/
十多岁	uds/
手电筒	udt/
山东省	udu/
水电站	udv/
史蒂文	udw/
是典型	udx/
圣诞夜	udy/
书呆子	udz/
涉恶案	uea/
少儿部	ueb/
舒尔茨	uec/
十二点	ued/
十二分	uef/
十二个	ueg/
十二号	ueh/
十二处	uei/
十二届	uej/
十二块	uek/
十二楼	uel/
事儿妈	uem/
十二年	uen/
十二篇	uep/
申恩庆	ueq/
十二日	uer/
十二岁	ues/
十二条	uet/
十二时	ueu/
十二种	uev/
十二万	uew/
沙耳乡	uex/
十二月	uey/
烧鹅仔	uez/
十分爱	ufa/
上腹部	ufb/
示范村	ufc/
双方都	ufd/
顺风耳	ufe/
示范法	uff/
示范岗	ufg/
是否会	ufh/
是非常	ufi/
书法家	ufj/
首付款	ufk/
说服力	ufl/
舒服吗	ufm/
是否能	ufn/
示范片	ufp/
示范区	ufq/
少夫人	ufr/
深肤色	ufs/
手扶梯	uft/
沙发上	ufu/
身份证	ufv/
收发文	ufw/
示范性	ufx/
双方应	ufy/
水分子	ufz/
食管癌	uga/
石膏板	ugb/
沙郭村	ugc/
闪光灯	ugd/
沙肝儿	uge/
施工方	ugf/
水鸪鸪	ugg/
手感好	ugh/
上过床	ugi/
收购价	ugj/
石膏矿	ugk/
收购了	ugl/
上规模	ugm/
是国内	ugn/
甚高频	ugp/
石拱桥	ugq/
是个人	ugr/
使公司	ugs/
施工图	ugt/
韶关市	ugu/
上岗证	ugv/
少工委	ugw/
石膏像	ugx/
上个月	ugy/
山岗子	ugz/
受贿案	uha/
生活报	uhb/
石花菜	uhc/
上海的	uhd/
瘦猴儿	uhe/
生活费	uhf/
山海关	uhg/
社会化	uhh/
珊瑚虫	uhi/
书画家	uhj/
沙河口	uhk/
社会里	uhl/
说话吗	uhm/
适合你	uhn/
实话哦	uho/
生活片	uhp/
生活区	uhq/
收货人	uhr/
深红色	uhs/
山核桃	uht/
上海市	uhu/
生活中	uhv/
生活网	uhw/
社会学	uhx/
适合于	uhy/
使孩子	uhz/
沈长安	uia/
市场部	uib/
时出错	uic/
上传到	uid/
手串儿	uie/
市场法	uif/
生产过	uig/
市场化	uih/
生产出	uii/
市场价	uij/
说出口	uik/
生产力	uil/
上场门	uim/
商场内	uin/
水产品	uip/
生成器	uiq/
上传人	uir/
市场司	uis/
视察团	uit/
市场上	uiu/
生产者	uiv/
生成物	uiw/
生产线	uix/
是出于	uiy/
审查组	uiz/
睡觉啊	uja/
世界杯	ujb/
时间词	ujc/
设计的	ujd/
山脚儿	uje/
设计费	ujf/
世界观	ujg/
手机号	ujh/
时间长	uji/
世界级	ujj/
数据库	ujk/
时间里	ujl/
世纪末	ujm/
时间内	ujn/
睡觉哦	ujo/
时间片	ujp/
是极其	ujq/
收件人	ujr/
世锦赛	ujs/
设计图	ujt/
实际上	uju/
石家庄	ujv/
时间为	ujw/
数据线	ujx/
始建于	ujy/
设计组	ujz/
时刻表	ukb/
水口村	ukc/
深刻的	ukd/
沙克尔	uke/
守空房	ukf/
时空观	ukg/
说空话	ukh/
收款处	uki/
收款机	ukj/
石坑崆	ukk/
顺口溜	ukl/
石库门	ukm/
是可能	ukn/
是可怕	ukp/
十块钱	ukq/
收款人	ukr/
石窟寺	uks/
收款台	ukt/
上课时	uku/
盛开着	ukv/
省科委	ukw/
市科协	ukx/
是可以	uky/
上口字	ukz/
使两岸	ula/
水利部	ulb/
数量词	ulc/
十六大	uld/
树凉儿	ule/
受理费	ulf/
输卵管	ulg/
实例化	ulh/
售楼处	uli/
十六届	ulj/
史莱克	ulk/
设立了	ull/
耍流氓	ulm/
十六年	uln/
实力派	ulp/
树立起	ulq/
十六日	ulr/
少林寺	uls/
水龙头	ult/
上来说	ulu/
胜利者	ulv/
十六位	ulw/
生理学	ulx/
是利用	uly/
舍利子	ulz/
什么啊	uma/
什么病	umb/
什么菜	umc/
什么的	umd/
升米恩	ume/
什么法	umf/
使命感	umg/
什么话	umh/
寿命长	umi/
湿毛巾	umj/
枢木葵	umk/
生命力	uml/
什么吗	umm/
什么呢	umn/
什么哦	umo/
什么牌	ump/
是目前	umq/
什么人	umr/
史密斯	ums/
商贸通	umt/
什么是	umu/
生命值	umv/
商贸网	umw/
生命线	umx/
什么也	umy/
什么最	umz/
施耐庵	una/
史努比	unb/
省内存	unc/
上年度	und/
水牛儿	une/
少年犯	unf/
是那个	ung/
十年后	unh/
水泥厂	uni/
神农架	unj/
肾内科	unk/
十年来	unl/
说你们	unm/
少奶奶	unn/
是你哦	uno/
施虐癖	unp/
十年前	unq/
是男人	unr/
室内赛	uns/
仕女图	unt/
少年时	unu/
是那种	unv/
室内外	unw/
神农溪	unx/
石脑油	uny/
少年组	unz/
视频啊	upa/
审批表	upb/
适配层	upc/
输配电	upd/
十盆儿	upe/
商品房	upf/
审判官	upg/
商品化	uph/
售票处	upi/
收盘价	upj/
射频卡	upk/
食品类	upl/
商品名	upm/
双皮奶	upn/
沈培培	upp/
适配器	upq/
审批人	upr/
世乒赛	ups/
说破天	upt/
山坡上	upu/
审判长	upv/
食品网	upw/
水平线	upx/
售票员	upy/
水瓶座	upz/
双氰胺	uqa/
申请表	uqb/
水芹菜	uqc/
失去的	uqd/
砂浅儿	uqe/
申请费	uqf/
上千个	uqg/
申请号	uqh/
说清楚	uqi/
双球菌	uqj/
首期款	uqk/
失去了	uql/
数千名	uqm/
时期内	uqn/
石桥铺	uqp/
上前去	uqq/
申请人	uqr/
十七岁	uqs/
上青天	uqt/
申请书	uqu/
申请者	uqv/
上千万	uqw/
授权下	uqx/
使企业	uqy/
烧茄子	uqz/
杀人案	ura/
受日本	urb/
是如此	urc/
深入的	urd/
收入额	ure/
输入法	urf/
输入过	urg/
上任后	urh/
双人床	uri/
双刃剑	urj/
输入框	urk/
是人类	url/
商人们	urm/
数日内	urn/
生日趴	urp/
十日前	urq/
受让人	urr/
上热搜	urs/
视乳头	urt/
上饶市	uru/
收入者	urv/
双人舞	urw/
水溶性	urx/
水溶液	ury/
杀人罪	urz/
上诉案	usa/
诗三百	usb/
十三层	usc/
世俗的	usd/
食宿费	usf/
十三个	usg/
世俗化	ush/
输送车	usi/
输送机	usj/
十三课	usk/
杀死了	usl/
收缩膜	usm/
十三年	usn/
十三篇	usp/
双色球	usq/
上诉人	usr/
十四岁	uss/
十三条	ust/
受损失	usu/
上诉状	usv/
十三万	usw/
伸缩性	usx/
使所有	usy/
神算子	usz/
收摊啊	uta/
手提包	utb/
生态村	utc/
渗透到	utd/
书摊儿	ute/
实体法	utf/
生态观	utg/
生态化	uth/
手推车	uti/
深天健	utj/
试题库	utk/
实体类	utl/
是他们	utm/
施泰纳	utn/
身体胖	utp/
上台前	utq/
受托人	utr/
沙滩伞	uts/
刷推特	utt/
汕头市	utu/
渗透着	utv/
上图为	utw/
生态学	utx/
晒太阳	uty/
山桐子	utz/
试试啊	uua/
试试吧	uub/
数十次	uuc/
深深的	uud/
双生儿	uue/
手术费	uuf/
数十个	uug/
说实话	uuh/
试生产	uui/
上世纪	uuj/
试试看	uuk/
收视率	uul/
说什么	uum/
数十年	uun/
上水平	uup/
蜀山区	uuq/
少数人	uur/
莎莎苏	uus/
是上天	uut/
事实上	uuu/
闪烁着	uuv/
数十万	uuw/
舒适性	uux/
数十亿	uuy/
射手座	uuz/
深圳啊	uva/
始终把	uvb/
使赵村	uvc/
是真的	uvd/
顺朱儿	uve/
市政府	uvf/
是中国	uvg/
甚至会	uvh/
设置成	uvi/
时装界	uvj/
双周刊	uvk/
甚至连	uvl/
是专门	uvm/
十周年	uvn/
少壮派	uvp/
生殖器	uvq/
室主任	uvr/
生长素	uvs/
手指头	uvt/
深圳市	uvu/
是真正	uvv/
设置为	uvw/
实质性	uvx/
甚至有	uvy/
甚至在	uvz/
是我啊	uwa/
商务部	uwb/
鼠尾草	uwc/
事物的	uwd/
屎味儿	uwe/
晌午饭	uwf/
是我国	uwg/
生物化	uwh/
商务车	uwi/
税务局	uwj/
上网卡	uwk/
商务楼	uwl/
使我们	uwm/
十五年	uwn/
十五篇	uwp/
商务区	uwq/
十五日	uwr/
事务所	uws/
商务通	uwt/
是我市	uwu/
守望者	uwv/
商务网	uww/
生物学	uwx/
是唯一	uwy/
手腕子	uwz/
伤心啊	uxa/
上下班	uxb/
属性词	uxc/
剩下的	uxd/
手心儿	uxe/
手续费	uxf/
鼠须管	uxg/
生效后	uxh/
筛选出	uxi/
摄像机	uxj/
首先看	uxk/
实现了	uxl/
上写明	uxm/
时限内	uxn/
双响炮	uxp/
市辖区	uxq/
双休日	uxr/
声学所	uxs/
摄像头	uxt/
山西省	uxu/
属性值	uxv/
上下文	uxw/
时效性	uxx/
首先要	uxy/
首先在	uxz/
声音啊	uya/
事业部	uyb/
上一次	uyc/
使用的	uyd/
是样儿	uye/
使用费	uyf/
是一个	uyg/
商业化	uyh/
商用车	uyi/
是一家	uyj/
是一款	uyk/
市盈率	uyl/
是一名	uym/
十一年	uyn/
属于偶	uyo/
上一篇	uyp/
使用权	uyq/
受益人	uyr/
是一所	uys/
示意图	uyt/
实验室	uyu/
是一种	uyv/
是因为	uyw/
是一项	uyx/
适用于	uyy/
是一座	uyz/
失踪案	uza/
肾脏病	uzb/
十字槽	uzc/
上匝道	uzd/
上座儿	uze/
实在法	uzf/
水族馆	uzg/
数字化	uzh/
上贼船	uzi/
使自己	uzj/
数字卡	uzk/
失踪了	uzl/
首字母	uzm/
是最能	uzn/
使作呕	uzo/
氏族谱	uzp/
受灾区	uzq/
受赠人	uzr/
深棕色	uzs/
狮子头	uzt/
实在是	uzu/
是自主	uzv/
狮子王	uzw/
水族箱	uzx/
水资源	uzy/
狮子座	uzz/
治安队	vad/
珍爱儿	vae/
至案发	vaf/
治安官	vag/
钟阿城	vai/
张艾嘉	vaj/
指𩽾𩾌	vak/
张爱玲	val/
转氨酶	vam/
只爱你	van/
张爱萍	vap/
振安区	vaq/
障碍赛	vas/
真爱他	vat/
真爱是	vau/
治安者	vav/
障碍物	vaw/
致癌性	vax/
治安员	vay/
专案组	vaz/
真笨啊	vba/
这不比	vbb/
真不错	vbc/
找不到	vbd/
这拨儿	vbe/
这部分	vbf/
只不过	vbg/
准备好	vbh/
转变成	vbi/
这不仅	vbj/
择不开	vbk/
只保留	vbl/
这表明	vbm/
终不能	vbn/
中北欧	vbo/
周扒皮	vbp/
这笔钱	vbq/
这帮人	vbr/
争霸赛	vbs/
周伯通	vbt/
这不是	vbu/
张柏芝	vbv/
转变为	vbw/
这部戏	vbx/
直播员	vby/
这辈子	vbz/
仲裁案	vca/
注册表	vcb/
珍藏册	vcc/
注册地	vcd/
找刺儿	vce/
注册费	vcf/
重仓股	vcg/
注册号	vch/
注册处	vci/
注册机	vcj/
主仓库	vck/
注册了	vcl/
注册码	vcm/
詹采妮	vcn/
主裁判	vcp/
周村区	vcq/
注册人	vcr/
真彩色	vcs/
仲裁庭	vct/
这才是	vcu/
注册证	vcv/
仲裁委	vcw/
政策性	vcx/
中草药	vcy/
只存在	vcz/
知道啊	vda/
脂蛋白	vdb/
助动词	vdc/
指定的	vdd/
找点儿	vde/
制定法	vdf/
钟点工	vdg/
真的很	vdh/
制定出	vdi/
战斗机	vdj/
长得快	vdk/
找到了	vdl/
知道吗	vdm/
知道你	vdn/
中东欧	vdo/
制动盘	vdp/
主动权	vdq/
这代人	vdr/
招待所	vds/
置顶帖	vdt/
指的是	vdu/
终点站	vdv/
镇党委	vdw/
指导下	vdx/
这对于	vdy/
装犊子	vdz/
这儿吧	veb/
猪耳朵	ved/
直愕愕	vee/
赵尔丰	vef/
折耳根	veg/
猪儿虫	vei/
专而精	vej/
舟蛾科	vek/
周恩来	vel/
折耳猫	vem/
张尔岐	veq/
周二三	ves/
卓尔坦	vet/
这儿是	veu/
这二者	vev/
真恶心	vex/
中耳炎	vey/
这儿子	vez/
真烦啊	vfa/
支付宝	vfb/
捉放曹	vfc/
丈夫的	vfd/
支付额	vfe/
主方法	vff/
支付给	vfg/
中发挥	vfh/
煮饭吃	vfi/
政府间	vfj/
支付卡	vfk/
征服了	vfl/
这方面	vfm/
祝福你	vfn/
战防炮	vfp/
蒸发器	vfq/
支付日	vfr/
脂肪酸	vfs/
正方体	vft/
真分数	vfu/
征服者	vfv/
政法委	vfw/
正方形	vfx/
正反应	vfy/
只负责	vfz/
这个啊	vga/
职改办	vgb/
中关村	vgc/
中国队	vgd/
长个儿	vge/
真功夫	vgf/
直勾勾	vgg/
正规化	vgh/
中国茶	vgi/
中高级	vgj/
政工科	vgk/
诸葛亮	vgl/
这个梦	vgm/
占国内	vgn/
周国平	vgp/
中国区	vgq/
中国人	vgr/
支公司	vgs/
转过头	vgt/
转过身	vgu/
只顾着	vgv/
中国网	vgw/
主观性	vgx/
重工业	vgy/
找工作	vgz/
真黄啊	vha/
指挥部	vhb/
祝贺词	vhc/
中获得	vhd/
这会儿	vhe/
止回阀	vhf/
指挥官	vhg/
这很好	vhh/
转换成	vhi/
周华健	vhj/
真好看	vhk/
整合了	vhl/
张惠妹	vhm/
中华女	vhn/
中华牌	vhp/
转换器	vhq/
这伙人	vhr/
指挥所	vhs/
主合同	vht/
珠海市	vhu/
甄嬛传	vhv/
转化为	vhw/
这或许	vhx/
指挥员	vhy/
这孩子	vhz/
直肠癌	via/
侦察兵	vib/
主持词	vic/
真诚的	vid/
抓碴儿	vie/
这充分	vif/
郑成功	vig/
支持环	vih/
轴承厂	vii/
中创建	vij/
主窗口	vik/
站出来	vil/
正常吗	vim/
支持你	vin/
制成品	vip/
中长期	viq/
主持人	vir/
战锤三	vis/
主窗体	vit/
战场上	viu/
支持者	viv/
正成为	viw/
支持下	vix/
正处于	viy/
正处在	viz/
着急啊	vja/
主机板	vjb/
中间层	vjc/
宅基地	vjd/
中间儿	vje/
中介费	vjf/
这几个	vjg/
这句话	vjh/
专家称	vji/
张家界	vjj/
张家口	vjk/
周杰伦	vjl/
专家们	vjm/
这几年	vjn/
正九品	vjp/
这就去	vjq/
主讲人	vjr/
证交所	vjs/
这几天	vjt/
这就是	vju/
占据着	vjv/
中纪委	vjw/
专家型	vjx/
转基因	vjy/
专家组	vjz/
真可爱	vka/
真空泵	vkb/
赵奎灿	vkc/
只看到	vkd/
抓空儿	vke/
朱可夫	vkf/
主考官	vkg/
中括号	vkh/
主客场	vki/
折扣价	vkj/
张可可	vkk/
召开了	vkl/
至昆明	vkm/
这可能	vkn/
真可怕	vkp/
制空权	vkq/
主考人	vkr/
中控锁	vks/
中控台	vkt/
这可是	vku/
准考证	vkv/
扎卡维	vkw/
只可惜	vkx/
中科院	vky/
张开嘴	vkz/
朱利安	vla/
这里吧	vlb/
这两次	vlc/
着力点	vld/
直溜儿	vle/
专利法	vlf/
这两个	vlg/
展览会	vlh/
质量差	vli/
这里就	vlj/
肿瘤科	vlk/
占领了	vll/
这里面	vlm/
这两年	vln/
战利品	vlp/
专利权	vlq/
周六日	vlr/
竹林寺	vls/
这两天	vlt/
这里是	vlu/
这两种	vlv/
这两位	vlw/
战略性	vlx/
致力于	vly/
治疗组	vlz/
真美啊	vma/
扎马步	vmb/
捉迷藏	vmc/
著名的	vmd/
照面儿	vme/
找麻烦	vmf/
这么个	vmg/
这么好	vmh/
这么长	vmi/
这么久	vmj/
这么快	vmk/
证明了	vml/
准妈妈	vmm/
啄木鸟	vmn/
这么拼	vmp/
这么巧	vmq/
掌门人	vmr/
詹姆斯	vms/
皱眉头	vmt/
这么说	vmu/
殖民者	vmv/
这么晚	vmw/
这么小	vmx/
中没有	vmy/
这么做	vmz/
竹内爱	vna/
只能把	vnb/
占内存	vnc/
这难道	vnd/
住那儿	vne/
詹妮弗	vnf/
只能够	vng/
智能化	vnh/
指南车	vni/
滞纳金	vnj/
智能卡	vnk/
找你了	vnl/
祝你们	vnm/
周南南	vnn/
中南欧	vno/
纸尿片	vnp/
周年庆	vnq/
中年人	vnr/
斩男色	vns/
这年头	vnt/
只能说	vnu/
指南针	vnv/
智能网	vnw/
智能型	vnx/
只能用	vny/
只能在	vnz/
兆欧表	vob/
炸藕荷	voh/
中欧城	voi/
证哦年	von/
诈骗案	vpa/
支票簿	vpb/
招牌菜	vpc/
长胖点	vpd/
照片儿	vpe/
真佩服	vpf/
装配工	vpg/
招聘会	vph/
制品厂	vpi/
照片集	vpj/
真漂亮	vpl/
这匹马	vpm/
只怕你	vpn/
郑佩佩	vpp/
支配权	vpq/
制片人	vpr/
招聘司	vps/
装配图	vpt/
只怕是	vpu/
招聘者	vpv/
张平文	vpw/
支配下	vpx/
制品业	vpy/
诈骗罪	vpz/
终期癌	vqa/
占全部	vqb/
中气层	vqc/
正确的	vqd/
竹签儿	vqe/
证券法	vqf/
占全国	vqg/
证券化	vqh/
沼气池	vqi/
中秋节	vqj/
追穷寇	vqk/
站起来	vql/
真奇妙	vqm/
中青年	vqn/
张庆鹏	vqp/
知情权	vqq/
债权人	vqr/
张琴松	vqs/
证券通	vqt/
站起身	vqu/
这其中	vqv/
证券网	vqw/
准确性	vqx/
证券业	vqy/
转圈子	vqz/
真人版	vrb/
张荣存	vrc/
转入地	vrd/
张睿恩	vre/
周润发	vrf/
主人公	vrg/
中日韩	vrh/
周汝昌	vri/
朱镕基	vrj/
主入口	vrk/
转日莲	vrl/
张瑞敏	vrm/
壮如牛	vrn/
植入片	vrp/
之日起	vrq/
真让人	vrr/
重入锁	vrs/
这让她	vrt/
钟乳石	vru/
准入制	vrv/
主人翁	vrw/
脂溶性	vrx/
智仁勇	vry/
正日子	vrz/
真骚啊	vsa/
转速表	vsb/
纸莎草	vsc/
追溯到	vsd/
赵四儿	vse/
住宿费	vsf/
这三个	vsg/
这似乎	vsh/
真丝绸	vsi/
珠三角	vsj/
札萨克	vsk/
猪饲料	vsl/
注塑模	vsm/
至三年	vsn/
正色片	vsp/
追索权	vsq/
这三人	vsr/
赵瑟瑟	vss/
这三条	vst/
住宿生	vsu/
这三种	vsv/
正所谓	vsw/
这三项	vsx/
之所以	vsy/
装孙子	vsz/
猪头啊	vta/
招投标	vtb/
主题词	vtc/
重特大	vtd/
这天恩	vte/
竹筒饭	vtf/
只提供	vtg/
招贴画	vth/
直通车	vti/
只听见	vtj/
这堂课	vtk/
这条路	vtl/
真他妈	vtm/
赵铁牛	vtn/
专题片	vtp/
主题曲	vtq/
猪头肉	vtr/
猪头三	vts/
直挺挺	vtt/
整体上	vtu/
只通知	vtv/
镇团委	vtw/
状态下	vtx/
止痛药	vty/
张贴在	vtz/
装傻啊	vua/
正式版	vub/
这是从	vuc/
知识的	vud/
正事儿	vue/
中山服	vuf/
这是个	vug/
这时候	vuh/
折射出	vui/
直升机	vuj/
知识库	vuk/
展示了	vul/
这说明	vum/
这是你	vun/
装饰品	vup/
注射器	vuq/
周树人	vur/
赭石色	vus/
这是他	vut/
中山市	vuu/
注视着	vuv/
这是我	vuw/
真实性	vux/
至少有	vuy/
只是在	vuz/
张治安	vva/
政治部	vvb/
竹枝词	vvc/
只知道	vvd/
支招儿	vve/
镇政府	vvf/
珍珠港	vvg/
着重号	vvh/
蘸着吃	vvi/
政治家	vvj/
政治课	vvk/
抓住了	vvl/
这种美	vvm/
指着你	vvn/
纸制品	vvp/
住宅区	vvq/
这种人	vvr/
蜘蛛丝	vvs/
这张图	vvt/
郑州市	vvu/
战争中	vvv/
蜘蛛网	vvw/
政治学	vvx/
专注于	vvy/
战争罪	vvz/
坠亡案	vwa/
中文版	vwb/
赵湾村	vwc/
照我的	vwd/
猪窝儿	vwe/
占位符	vwf/
这五个	vwg/
专委会	vwh/
转弯处	vwi/
之我见	vwj/
张威科	vwk/
掌握了	vwl/
中文名	vwm/
只为你	vwn/
折文旁	vwp/
中晚期	vwq/
债务人	vwr/
指纹锁	vws/
张闻天	vwt/
这位是	vwu/
掌握着	vwv/
中文网	vww/
中文系	vwx/
这无疑	vwy/
中文字	vwz/
质询案	vxa/
中西部	vxb/
展现层	vxc/
这些都	vxd/
招笑儿	vxe/
朱学范	vxf/
执行官	vxg/
这些话	vxh/
周星驰	vxi/
照相机	vxj/
专修科	vxk/
执行力	vxl/
真羡慕	vxm/
这些年	vxn/
转向盘	vxp/
中心区	vxq/
这些人	vxr/
珠心算	vxs/
主席团	vxt/
直辖市	vxu/
执行者	vxv/
中新网	vxw/
中小学	vxx/
只需要	vxy/
这小子	vxz/
这样啊	vya/
职业病	vyb/
这一次	vyc/
重要的	vyd/
扎伊尔	vye/
这一方	vyf/
找一个	vyg/
专业化	vyh/
制药厂	vyi/
这样就	vyj/
专业课	vyk/
注意力	vyl/
张艺谋	vym/
只要你	vyn/
这样哦	vyo/
专用品	vyp/
这一切	vyq/
占有人	vyr/
这样算	vys/
这一天	vyt/
主要是	vyu/
志愿者	vyv/
中英文	vyw/
重要性	vyx/
主要有	vyy/
这样做	vyz/
周子安	vza/
至尊宝	vzb/
庄子祠	vzc/
制作的	vzd/
支嘴儿	vze/
制作费	vzf/
转载稿	vzg/
栀子花	vzh/
制造出	vzi/
装载机	vzj/
赈灾款	vzk/
周总理	vzl/
掌子面	vzm/
张子宁	vzn/
制造品	vzp/
著作权	vzq/
制作人	vzr/
制造所	vzs/
中子态	vzt/
制造商	vzu/
制作者	vzv/
指责为	vzw/
正在向	vzx/
制造业	vzy/
制作组	vzz/
我暗暗	waa/
万安村	wac/
微暗的	wad/
慰安妇	waf/
武安国	wag/
我爱吃	wai/
五爱街	waj/
万艾可	wak/
王爱丽	wal/
我爱你	wan/
晚安哦	wao/
未安排	wap/
为爱情	waq/
我爱人	war/
慰安所	was/
我爱他	wat/
王安石	wau/
未安装	wav/
我爱玩	waw/
文安县	wax/
王安忆	way/
我不爱	wba/
我并不	wbb/
五百次	wbc/
完备的	wbd/
围脖儿	wbe/
往北方	wbf/
我不敢	wbg/
我不会	wbh/
玩不成	wbi/
为背景	wbj/
文本框	wbk/
微波炉	wbl/
为避免	wbm/
我不能	wbn/
我不怕	wbp/
我不去	wbq/
五百人	wbr/
五百岁	wbs/
我不太	wbt/
我不是	wbu/
为保证	wbv/
五百万	wbw/
我不想	wbx/
我不要	wby/
我不在	wbz/
我猜啊	wca/
我从不	wcb/
我猜测	wcc/
未曾得	wcd/
午餐费	wcf/
外侧沟	wcg/
午餐后	wch/
五彩池	wci/
我曾经	wcj/
我才看	wck/
我从来	wcl/
卧槽马	wcm/
未采纳	wcn/
汪曾祺	wcq/
午餐肉	wcr/
问苍天	wct/
五彩石	wcu/
未猜中	wcv/
我从未	wcw/
我从小	wcx/
未曾有	wcy/
误操作	wcz/
我的爱	wda/
为代表	wdb/
我的错	wdc/
稳定的	wdd/
晚点儿	wde/
沃达丰	wdf/
我大概	wdg/
我都会	wdh/
我当初	wdi/
为大家	wdj/
我打开	wdk/
我得了	wdl/
我多么	wdm/
微电脑	wdn/
武当派	wdp/
我的确	wdq/
我当然	wdr/
我打算	wds/
我的头	wdt/
我当时	wdu/
我带着	wdv/
武大伟	wdw/
稳定性	wdx/
万多元	wdy/
微电子	wdz/
玩儿啊	wea/
威尔伯	web/
外耳道	wed/
沃尔夫	wef/
玩儿个	weg/
乌尔禾	weh/
玩儿成	wei/
威尔基	wej/
威尔康	wek/
玩儿烂	wel/
沃尔玛	wem/
玩儿腻	wen/
玩儿票	wep/
戊二醛	weq/
维尔容	wer/
威尔斯	wes/
沃尔特	wet/
威尔士	weu/
玩儿转	wev/
沃尔沃	wew/
威尔逊	wex/
威尔鹰	wey/
我儿子	wez/
胃复安	wfa/
为方便	wfb/
五丰村	wfc/
违法的	wfd/
吾甫尔	wfe/
我仿佛	wff/
无缝管	wfg/
晚饭后	wfh/
微风吹	wfi/
王府井	wfj/
未付款	wfk/
违反了	wfl/
五方面	wfm/
我发你	wfn/
往返票	wfp/
我父亲	wfq/
王夫人	wfr/
卧佛寺	wfs/
文峰塔	wft/
无非是	wfu/
为防止	wfv/
网服务	wfw/
我发现	wfx/
往返于	wfy/
微分子	wfz/
王国安	wga/
我根本	wgb/
我刚才	wgc/
为广大	wgd/
沃格尔	wge/
为规范	wgf/
我刚刚	wgg/
无公害	wgh/
为贯彻	wgi/
为国家	wgj/
未公开	wgk/
为鼓励	wgl/
王光美	wgm/
我给你	wgn/
顽固派	wgp/
我过去	wgq/
外国人	wgr/
我公司	wgs/
我跟他	wgt/
外观上	wgu/
吴官正	wgv/
王国维	wgw/
我高兴	wgx/
五个亿	wgy/
五个字	wgz/
蔚海岸	wha/
文化部	whb/
文化村	whc/
完好的	whd/
外活儿	whe/
维护费	whf/
文化馆	whg/
娃哈哈	whh/
文化城	whi/
文化节	whj/
文化课	whk/
文化路	whl/
我还没	whm/
我还能	whn/
我害怕	whp/
未婚妻	whq/
文化人	whr/
文化司	whs/
我和他	wht/
武汉市	whu/
文化站	whv/
为何物	whw/
为核心	whx/
我还有	why/
我还在	whz/
望长安	wia/
无差别	wib/
无差错	wic/
胃肠道	wid/
吴承恩	wie/
我吃饭	wif/
文抄公	wig/
完成后	wih/
我常常	wii/
未成交	wij/
胃穿孔	wik/
完成了	wil/
文昌门	wim/
未成年	win/
望城坡	wip/
武昌区	wiq/
我承认	wir/
武承嗣	wis/
无出头	wit/
完成时	wiu/
维持着	wiv/
无臭味	wiw/
文成县	wix/
胃肠炎	wiy/
维持在	wiz/
我骄傲	wja/
温家宝	wjb/
王家村	wjc/
我觉得	wjd/
维吉尔	wje/
微积分	wjf/
危机感	wjg/
我几乎	wjh/
为基础	wji/
文件夹	wjj/
为加快	wjk/
忘记了	wjl/
文件名	wjm/
为纪念	wjn/
违禁品	wjp/
为加强	wjq/
我竟然	wjr/
文件锁	wjs/
为家庭	wjt/
我就是	wju/
文件中	wjv/
王家卫	wjw/
我就想	wjx/
我建议	wjy/
我就在	wjz/
我看啊	wka/
我可不	wkb/
无库存	wkc/
我看到	wkd/
五块二	wke/
未开发	wkf/
我看过	wkg/
为客户	wkh/
万科城	wki/
我看见	wkj/
我看看	wkk/
乌克兰	wkl/
为楷模	wkm/
我看你	wkn/
我恐怕	wkp/
温控器	wkq/
尾款人	wkr/
五棵松	wks/
王磡头	wkt/
温开水	wku/
我看着	wkv/
我渴望	wkw/
外科学	wkx/
我可以	wky/
万颗子	wkz/
为了爱	wla/
网络版	wlb/
网络层	wlc/
未来的	wld/
乌拉尔	wle/
晚礼服	wlf/
我老公	wlg/
网络化	wlh/
乌龙茶	wli/
为了将	wlj/
我离开	wlk/
我来了	wll/
外立面	wlm/
为了能	wln/
无聊哦	wlo/
我老婆	wlp/
为了钱	wlq/
为了让	wlr/
蔚蓝色	wls/
无厘头	wlt/
无论是	wlu/
我拉着	wlv/
为了我	wlw/
物理学	wlx/
五粮液	wly/
为了在	wlz/
我没啊	wma/
我们不	wmb/
我们从	wmc/
完美的	wmd/
沃米尔	wme/
我没法	wmf/
外蒙古	wmg/
文明号	wmh/
我们厂	wmi/
我们将	wmj/
我没看	wmk/
我们俩	wml/
我妈妈	wmm/
武媚娘	wmn/
唯美派	wmp/
我们却	wmq/
文明人	wmr/
我们仨	wms/
我每天	wmt/
我们是	wmu/
无名指	wmv/
文明委	wmw/
我们想	wmx/
万美元	wmy/
为满足	wmz/
问你啊	wna/
为哪般	wnb/
无奈地	wnd/
我女儿	wne/
窝囊废	wnf/
我能够	wng/
五年后	wnh/
挖泥船	wni/
五年级	wnj/
我宁可	wnk/
五年来	wnl/
为你们	wnm/
五年内	wnn/
无奈哦	wno/
无脑捧	wnp/
五年前	wnq/
无内容	wnr/
威尼斯	wns/
我那天	wnt/
王女士	wnu/
五年制	wnv/
玩腻味	wnw/
我内心	wnx/
我宁愿	wny/
我能做	wnz/
玩偶屋	wow/
为偶像	wox/
我怕啊	wpa/
尾盘报	wpb/
外胚层	wpc/
顽皮的	wpd/
五盆儿	wpe/
我佩服	wpf/
顽皮鬼	wpg/
为配合	wph/
卧铺车	wpi/
外婆家	wpj/
玩扑克	wpk/
我怕了	wpl/
我拼命	wpm/
我陪你	wpn/
我拍拍	wpp/
外婆桥	wpq/
汪佩蓉	wpr/
蛙皮素	wps/
无配套	wpt/
我平时	wpu/
我陪着	wpv/
王佩雯	wpw/
武平县	wpx/
我朋友	wpy/
王胖子	wpz/
武器啊	wqa/
为确保	wqb/
温泉村	wqc/
无情的	wqd/
五千二	wqe/
物权法	wqf/
我去过	wqg/
万泉河	wqh/
网球场	wqi/
为契机	wqj/
我请客	wqk/
我去了	wql/
往前面	wqm/
五千年	wqn/
网球拍	wqp/
我轻轻	wqq/
未确认	wqr/
网球赛	wqs/
问青天	wqt/
完全是	wqu/
为群众	wqv/
五千万	wqw/
文曲星	wqx/
为企业	wqy/
往前走	wqz/
温瑞安	wra/
吴仁宝	wrb/
我认错	wrc/
微软的	wrd/
乌瑞恩	wre/
为人父	wrf/
无人管	wrg/
为日后	wrh/
王瑞昌	wri/
无人机	wrj/
万人坑	wrk/
我忍了	wrl/
为人民	wrm/
我日你	wrn/
我日哦	wro/
我人品	wrp/
无人区	wrq/
我日日	wrr/
伍仁酥	wrs/
我让她	wrt/
我认识	wru/
围绕着	wrv/
我认为	wrw/
侮辱性	wrx/
污染源	wry/
围绕在	wrz/
吴四宝	wsb/
无色彩	wsc/
萎缩的	wsd/
温思尔	wse/
未遂犯	wsf/
吴三桂	wsg/
无损耗	wsh/
无色差	wsi/
无色界	wsj/
吴淞口	wsk/
我死了	wsl/
威斯敏	wsm/
我送你	wsn/
乌索普	wsp/
无所求	wsq/
王斯然	wsr/
威瑟斯	wss/
文森特	wst/
无损伤	wsu/
无所住	wsv/
无所谓	wsw/
萎缩性	wsx/
万岁爷	wsy/
外孙子	wsz/
无头案	wta/
问题吧	wtb/
乌塌菜	wtc/
为推动	wtd/
瓦铁尔	wte/
委托方	wtf/
为提高	wtg/
渥太华	wth/
我掏出	wti/
无条件	wtj/
外太空	wtk/
我听了	wtl/
为他们	wtm/
我挺你	wtn/
网拓扑	wtp/
我抬起	wtq/
委托人	wtr/
为特色	wts/
我天天	wtt/
问题是	wtu/
为特征	wtv/
委托物	wtw/
未填写	wtx/
我同意	wty/
我躺在	wtz/
我是啊	wua/
卫生部	wub/
无数次	wuc/
旺盛的	wud/
五十二	wue/
我师傅	wuf/
我是个	wug/
为生活	wuh/
为生产	wui/
卫生间	wuj/
卫生科	wuk/
文史类	wul/
为什么	wum/
五十年	wun/
往上爬	wup/
无霜期	wuq/
我输入	wur/
维生素	wus/
万事通	wut/
我身上	wuu/
我始终	wuv/
微生物	wuw/
为实现	wux/
卫生院	wuy/
我实在	wuz/
无障碍	wva/
完整版	wvb/
未注册	wvc/
我知道	wvd/
我这儿	wve/
我这份	wvf/
为这个	wvg/
我只好	wvh/
伪装成	wvi/
无止境	wvj/
无折扣	wvk/
我这里	wvl/
未注明	wvm/
我只能	wvn/
无照片	wvp/
万州区	wvq/
温州人	wvr/
五针松	wvs/
为主题	wvt/
我只是	wvu/
无症状	wvv/
我周围	wvw/
为中心	wvx/
我终于	wvy/
我站在	wvz/
维维安	wwa/
往往把	wwb/
娃娃菜	wwc/
微微的	wwd/
维吾尔	wwe/
文物法	wwf/
网纹辊	wwg/
往往会	wwh/
未完成	wwi/
慰问金	wwj/
往外看	wwk/
我忘了	wwl/
为我们	wwm/
我为你	wwn/
慰问品	wwp/
碗碗腔	wwq/
无污染	wwr/
万万岁	wws/
我问他	wwt/
往往是	wwu/
威望值	wwv/
万维网	www/
我微笑	wwx/
五万元	wwy/
五味子	wwz/
我想啊	wxa/
韦小宝	wxb/
无限次	wxc/
危险的	wxd/
温西尔	wxe/
维修费	wxf/
维修工	wxg/
我喜欢	wxh/
维修厂	wxi/
五星级	wxj/
往下看	wxk/
我心里	wxl/
我想买	wxm/
我想你	wxn/
危险品	wxp/
我想起	wxq/
外星人	wxr/
文学所	wxs/
我想他	wxt/
无锡市	wxu/
微笑着	wxv/
我希望	wxw/
我相信	wxx/
我想要	wxy/
我现在	wxz/
我晕啊	wya/
我也不	wyb/
外逸层	wyc/
唯一的	wyd/
玩意儿	wye/
物业费	wyf/
我一个	wyg/
委员会	wyh/
我要吃	wyi/
我已经	wyj/
我一看	wyk/
为原料	wyl/
我也没	wym/
维也纳	wyn/
我晕哦	wyo/
微硬盘	wyp/
我以前	wyq/
我依然	wyr/
位运算	wys/
为一体	wyt/
无疑是	wyu/
我一直	wyv/
我以为	wyw/
玩游戏	wyx/
我愿意	wyy/
我也在	wyz/
我最爱	wza/
文字版	wzb/
湾子村	wzc/
我再顶	wzd/
围嘴儿	wze/
外祖父	wzf/
为祖国	wzg/
为做好	wzh/
未造成	wzi/
为自己	wzj/
苇子坑	wzk/
屋子里	wzl/
我怎么	wzm/
我怎能	wzn/
我最怕	wzp/
五子棋	wzq/
无责任	wzr/
外资司	wzs/
为载体	wzt/
我总是	wzu/
为宗旨	wzv/
我昨晚	wzw/
吴宗宪	wzx/
我再也	wzy/
我坐在	wzz/
许安安	xaa/
新安村	xac/
西奥多	xad/
性爱抚	xaf/
性爱观	xag/
许鞍华	xah/
心安处	xai/
新安江	xaj/
相爱了	xal/
兴安盟	xam/
想爱你	xan/
消癌平	xap/
翔安区	xaq/
小矮人	xar/
缬氨酸	xas/
谢安桐	xat/
西安市	xau/
先安装	xav/
邢傲伟	xaw/
献爱心	xax/
小阿姨	xay/
小矮子	xaz/
下班啊	xba/
新版本	xbb/
小白菜	xbc/
想不到	xbd/
下绊儿	xbe/
想办法	xbf/
学不乖	xbg/
下班后	xbh/
下半场	xbi/
相比较	xbj/
星巴克	xbk/
性伴侣	xbl/
细胞膜	xbm/
下半年	xbn/
西北欧	xbo/
西柏坡	xbp/
想不起	xbq/
向别人	xbr/
选拔赛	xbs/
小白兔	xbt/
下半身	xbu/
新标准	xbv/
小霸王	xbw/
行不行	xbx/
西班牙	xby/
下辈子	xbz/
下次吧	xcb/
下曹村	xcc/
西餐店	xcd/
雄蚕蛾	xce/
胁从犯	xcf/
小餐馆	xcg/
新词汇	xch/
线材厂	xci/
性刺激	xcj/
小仓库	xck/
新材料	xcl/
小聪明	xcm/
笑翠鸟	xcn/
协操坪	xcp/
香草醛	xcq/
香菜日	xcr/
香菜碎	xcs/
西餐厅	xct/
性措施	xcu/
幸存者	xcv/
小错误	xcw/
修辞学	xcx/
小测验	xcy/
小册子	xcz/
修订案	xda/
行动吧	xdb/
许多次	xdc/
相当大	xdd/
鞋带儿	xde/
新东方	xdf/
信得过	xdg/
现代化	xdh/
相抵触	xdi/
向大家	xdj/
先打开	xdk/
想到了	xdl/
兄弟们	xdm/
想当年	xdn/
现代派	xdp/
消毒器	xdq/
许多人	xdr/
香豆素	xds/
心电图	xdt/
行动上	xdu/
行动中	xdv/
小动物	xdw/
小东西	xdx/
相当于	xdy/
小动作	xdz/
邪恶爱	xea/
夏尔巴	xeb/
新二村	xec/
希尔顿	xed/
肖恩恩	xee/
希尔芙	xef/
谢尔盖	xeg/
西二环	xeh/
细而长	xei/
小而精	xej/
小儿科	xek/
性恶论	xel/
谢尔曼	xem/
小儿女	xen/
西恩潘	xep/
小而全	xeq/
心恶热	xer/
西尔斯	xes/
刑二庭	xet/
形而上	xeu/
邪恶者	xev/
席尔瓦	xew/
形而下	xex/
小恩雅	xey/
小儿子	xez/
新方案	xfa/
信访办	xfb/
想发财	xfc/
幸福的	xfd/
戏份儿	xfe/
新方法	xff/
幸福感	xfg/
相符合	xfh/
消防车	xfi/
兴奋剂	xfj/
消费卡	xfk/
下发了	xfl/
幸福吗	xfm/
小放牛	xfn/
须浮鸥	xfo/
消费品	xfp/
消费群	xfq/
西方人	xfr/
新粉丝	xfs/
下腹痛	xft/
消费税	xfu/
消费者	xfv/
新服务	xfw/
新发现	xfx/
性反应	xfy/
小房子	xfz/
修改案	xga/
学工部	xgb/
香根草	xgc/
新规定	xgd/
香干儿	xge/
下功夫	xgf/
小广告	xgg/
效果好	xgh/
性高潮	xgi/
向国家	xgj/
谢广坤	xgk/
习惯了	xgl/
小规模	xgm/
新概念	xgn/
西瓜皮	xgp/
修改器	xgq/
香港人	xgr/
新公司	xgs/
效果图	xgt/
小故事	xgu/
小公主	xgv/
小怪物	xgw/
相关性	xgx/
新工艺	xgy/
悬挂在	xgz/
西海岸	xha/
小伙伴	xhb/
杏花村	xhc/
消化道	xhd/
细活儿	xhe/
新回复	xhf/
新华光	xhg/
小混混	xhh/
喜欢吃	xhi/
相互间	xhj/
消化科	xhk/
学会了	xhl/
小红帽	xhm/
喜欢你	xhn/
消耗品	xhp/
徐汇区	xhq/
行贿人	xhr/
巡回赛	xhs/
喜欢他	xht/
西红柿	xhu/
泄洪闸	xhv/
新华网	xhw/
小户型	xhx/
新会员	xhy/
小孩子	xhz/
谢长安	xia/
宣传部	xib/
宣传册	xic/
宣传单	xid/
戏出儿	xie/
宣传费	xif/
新成果	xig/
现场会	xih/
线程池	xii/
县处级	xij/
新窗口	xik/
形成了	xil/
现查明	xim/
辛丑年	xin/
新产品	xip/
西城区	xiq/
宣传日	xir/
线程锁	xis/
相冲突	xit/
小城市	xiu/
小城镇	xiv/
想成为	xiw/
新车型	xix/
新成员	xiy/
小虫子	xiz/
袭警案	xja/
性价比	xjb/
新教材	xjc/
先进的	xjd/
心劲儿	xje/
选举法	xjf/
小酒馆	xjg/
相结合	xjh/
小轿车	xji/
新经济	xjj/
新街口	xjk/
下降了	xjl/
新局面	xjm/
想见你	xjn/
新加坡	xjp/
小技巧	xjq/
选举人	xjr/
性激素	xjs/
心绞痛	xjt/
新技术	xju/
向记者	xjv/
县纪委	xjw/
下决心	xjx/
性教育	xjy/
小舅子	xjz/
小可爱	xka/
新课标	xkb/
夏枯草	xkc/
小蝌蚪	xkd/
小卡尔	xke/
许可方	xkf/
新开工	xkg/
向客户	xkh/
新课程	xki/
新科技	xkj/
想看看	xkk/
辛苦了	xkl/
辛苦吗	xkm/
小困难	xkn/
新开辟	xkp/
许可权	xkq/
许可人	xkr/
悬空寺	xks/
新课题	xkt/
新款式	xku/
许可证	xkv/
星空网	xkw/
星空下	xkx/
新凯越	xky/
锡克族	xkz/
西来庵	xla/
线路板	xlb/
行李舱	xlc/
心理的	xld/
西里尔	xle/
学雷锋	xlf/
效率高	xlg/
序列号	xlh/
下了车	xli/
想了解	xlj/
希拉克	xlk/
下来了	xll/
小流氓	xlm/
小龙女	xln/
下了哦	xlo/
小礼品	xlp/
下楼去	xlq/
希腊人	xlr/
祥林嫂	xls/
线粒体	xlt/
心理上	xlu/
训练中	xlv/
新浪网	xlw/
心理学	xlx/
夏令营	xly/
新路子	xlz/
羡慕啊	xma/
项目部	xmb/
新名词	xmc/
鲜明的	xmd/
邪门儿	xme/
小蜜蜂	xmf/
向美国	xmg/
香蜜湖	xmh/
畜牧场	xmi/
畜牧局	xmj/
小煤矿	xmk/
消灭了	xml/
小妹妹	xmm/
洗面奶	xmn/
虾米皮	xmp/
西门庆	xmq/
洗面乳	xmr/
席梦思	xms/
新媒体	xmt/
厦门市	xmu/
心目中	xmv/
小木屋	xmw/
小猫熊	xmx/
畜牧业	xmy/
西门子	xmz/
星奈爱	xna/
西南部	xnb/
新农村	xnc/
虚拟的	xnd/
小女儿	xne/
西南方	xnf/
小南瓜	xng/
小女孩	xnh/
小农场	xni/
虚拟机	xnj/
心内科	xnk/
性能力	xnl/
向农民	xnm/
鲜牛奶	xnn/
逊尼派	xnp/
西南区	xnq/
小女人	xnr/
心钠素	xns/
想念他	xnt/
西宁市	xnu/
小哪吒	xnv/
校内外	xnw/
新女性	xnx/
新能源	xny/
小女子	xnz/
吸欧气	xoq/
西欧人	xor/
新偶像	xox/
姓欧阳	xoy/
向旁边	xpb/
橡皮擦	xpc/
相匹敌	xpd/
小婆儿	xpe/
小平房	xpf/
小排骨	xpg/
相配合	xph/
修配厂	xpi/
鲜啤酒	xpj/
小批量	xpl/
相媲美	xpm/
橡皮泥	xpn/
相匹配	xpp/
橡皮圈	xpq/
相配人	xpr/
辛普森	xps/
相配套	xpt/
斜坡上	xpu/
新品种	xpv/
小品文	xpw/
小螃蟹	xpx/
小朋友	xpy/
芯片组	xpz/
稀奇啊	xqa/
学前班	xqb/
需求侧	xqc/
新起点	xqd/
星期二	xqe/
需求方	xqf/
向全国	xqg/
星期后	xqh/
小汽车	xqi/
辛弃疾	xqj/
新情况	xqk/
星期六	xql/
乡亲们	xqm/
小区内	xqn/
向前跑	xqp/
向全球	xqq/
星期日	xqr/
星期四	xqs/
星期天	xqt/
新趋势	xqu/
先驱者	xqv/
星期五	xqw/
新气象	xqx/
小企业	xqy/
向前走	xqz/
信任案	xra/
小日本	xrb/
形容词	xrc/
县人大	xrd/
信瓤儿	xre/
吸入阀	xrf/
信任感	xrg/
显然会	xrh/
杏仁茶	xri/
现如今	xrj/
向日葵	xrk/
陷入了	xrl/
向人们	xrm/
想让你	xrn/
信任票	xrp/
行人情	xrq/
雪容融	xrr/
鲜肉色	xrs/
雪人套	xrt/
显然是	xru/
仙人掌	xrv/
新任务	xrw/
虚荣心	xrx/
显然有	xry/
显然在	xrz/
硝酸铵	xsa/
小三八	xsb/
下三层	xsc/
迅速的	xsd/
小嗓儿	xse/
刑诉法	xsf/
硝酸钙	xsg/
西三环	xsh/
消色差	xsi/
新四军	xsj/
小三科	xsk/
新思路	xsl/
硝酸镁	xsm/
硝酸钠	xsn/
新赛欧	xso/
小算盘	xsp/
西三旗	xsq/
性骚扰	xsr/
新搜索	xss/
新宋体	xst/
像素数	xsu/
寻思着	xsv/
新思维	xsw/
新思想	xsx/
向所有	xsy/
相思子	xsz/
泄题案	xta/
新台币	xtb/
新塘村	xtc/
新天地	xtd/
小天鹅	xte/
谢霆锋	xtf/
需提供	xtg/
系统化	xth/
现提出	xti/
新台阶	xtj/
向天空	xtk/
希特勒	xtl/
向他们	xtm/
小缇娜	xtn/
新突破	xtp/
小提琴	xtq/
心太软	xtr/
显通寺	xts/
小团体	xtt/
小贴士	xtu/
系统中	xtv/
校团委	xtw/
系统性	xtx/
相统一	xty/
小兔子	xtz/
凶杀案	xua/
销售部	xub/
小山村	xuc/
形式的	xud/
销售额	xue/
修饰符	xuf/
小时工	xug/
性生活	xuh/
显示出	xui/
新世纪	xuj/
显示卡	xuk/
消失了	xul/
学生们	xum/
小时内	xun/
显示屏	xup/
显示器	xuq/
向世人	xur/
学生司	xus/
小石头	xut/
销售商	xuu/
现实中	xuv/
显示为	xuw/
形势下	xux/
相适应	xuy/
消失在	xuz/
修正案	xva/
线装本	xvb/
行政村	xvc/
显著的	xvd/
下周二	xve/
县政府	xvf/
新中国	xvg/
修正后	xvh/
行政处	xvi/
新专辑	xvj/
新周刊	xvk/
限制了	xvl/
西直门	xvm/
下中农	xvn/
写这篇	xvp/
行政区	xvq/
系主任	xvr/
下周三	xvs/
小纸条	xvt/
笑着说	xvu/
象征着	xvv/
学中文	xvw/
限制性	xvx/
像这样	xvy/
限制在	xvz/
想文案	xwa/
新闻办	xwb/
洗物槽	xwc/
谢文东	xwd/
小娃儿	xwe/
新玩法	xwf/
新闻稿	xwg/
相吻合	xwh/
下午茶	xwi/
显微镜	xwj/
胸外科	xwk/
询问了	xwl/
向我们	xwm/
希望能	xwn/
想我哦	xwo/
新闻片	xwp/
宣武区	xwq/
行为人	xwr/
纤维素	xws/
新问题	xwt/
新闻社	xwu/
写文章	xwv/
新闻网	xww/
新闻学	xwx/
希望有	xwy/
小王子	xwz/
谢谢啊	xxa/
学习班	xxb/
先行词	xxc/
想象的	xxd/
消息儿	xxe/
信息费	xxf/
信息港	xxg/
信息化	xxh/
消息称	xxi/
相衔接	xxj/
选项卡	xxk/
新西兰	xxl/
新项目	xxm/
谢谢你	xxn/
谢谢哦	xxo/
徐小平	xxp/
肖像权	xxq/
休息日	xxr/
信息素	xxs/
相协调	xxt/
小学生	xxu/
学习者	xxv/
信息网	xxw/
学习型	xxx/
信息员	xxy/
像现在	xxz/
性与爱	xya/
下一步	xyb/
下一次	xyc/
新一代	xyd/
小鱼儿	xye/
洗衣粉	xyf/
下一个	xyg/
新用户	xyh/
小阴唇	xyi/
洗衣机	xyj/
信用卡	xyk/
吸引了	xyl/
学员们	xym/
需要你	xyn/
小燕鸥	xyo/
下一批	xyp/
新要求	xyq/
吸引人	xyr/
新元素	xys/
小丫头	xyt/
协议书	xyu/
信用证	xyv/
校园网	xyw/
小游戏	xyx/
下一页	xyy/
需要在	xyz/
现在啊	xza/
心脏病	xzb/
现在才	xzc/
现在都	xzd/
下崽儿	xze/
学杂费	xzf/
选择过	xzg/
下载后	xzh/
修造厂	xzi/
现在就	xzj/
选择框	xzk/
写字楼	xzl/
学子们	xzm/
现在呢	xzn/
新作品	xzp/
选择权	xzq/
学做人	xzr/
小组赛	xzs/
选择题	xzt/
现在是	xzu/
下载站	xzv/
写作文	xzw/
选择性	xzx/
现在又	xzy/
行走在	xzz/
要爱爱	yaa/
永安村	yac/
幽暗的	yad/
袁艾菲	yaf/
圆澳龟	yag/
衣阿华	yah/
阴暗处	yai/
亚氨基	yaj/
延安路	yal/
阴暗面	yam/
姚安娜	yan/
已安排	yap/
以安全	yaq/
延安颂	yas/
言安堂	yat/
延安市	yau/
应按照	yav/
颐澳湾	yaw/
有爱心	yax/
迎奥运	yay/
杨安泽	yaz/
有病啊	yba/
一步步	ybb/
也不错	ybc/
一般的	ybd/
鸭脖儿	ybe/
一部分	ybf/
也不过	ybg/
也不会	ybh/
一边吃	ybi/
由北京	ybj/
也包括	ybk/
用不了	ybl/
以避免	ybm/
也不能	ybn/
也不怕	ybp/
一笔钱	ybq/
一般人	ybr/
银白色	ybs/
有不同	ybt/
有不少	ybu/
与本站	ybv/
与本网	ybw/
也必须	ybx/
有必要	yby/
一辈子	ybz/
乙草胺	yca/
一次吧	ycb/
一次次	ycc/
依存度	ycd/
因此而	yce/
一次方	ycf/
有才干	ycg/
有才华	ych/
因此处	yci/
以促进	ycj/
英才卡	yck/
原材料	ycl/
隐藏门	ycm/
有才能	ycn/
硬磁盘	ycp/
应采取	ycq/
一撮人	ycr/
隐藏所	ycs/
洋葱头	yct/
依次是	ycu/
隐藏着	ycv/
依次为	ycw/
一次性	ycx/
应采用	ycy/
因此在	ycz/
印第安	yda/
一定不	ydb/
一道菜	ydc/
一点点	ydd/
一点儿	yde/
与地方	ydf/
遇到过	ydg/
一定会	ydh/
运动场	ydi/
一等奖	ydj/
阴道口	ydk/
意大利	ydl/
源代码	ydm/
一定能	ydn/
一大批	ydp/
阅读器	ydq/
有的人	ydr/
胰岛素	yds/
有独特	ydt/
一定是	ydu/
阅读者	ydv/
原单位	ydw/
有点像	ydx/
一定要	ydy/
应当在	ydz/
乙二胺	yea/
眼耳鼻	yeb/
于尔岑	yec/
余额达	yed/
幺二二	yee/
伊尔凡	yef/
一耳光	yeg/
因而会	yeh/
乙二醇	yei/
一二九	yej/
益尔康	yek/
爷儿俩	yel/
爷儿们	yem/
养二奶	yen/
亚尔帕	yep/
婴儿期	yeq/
一二三	yes/
雅尔塔	yet/
因而是	yeu/
婴儿装	yev/
余额为	yew/
幼儿学	yex/
幼儿园	yey/
因而在	yez/
缘分啊	yfa/
也分别	yfb/
要服从	yfc/
衣服的	yfd/
意粉儿	yfe/
一幅幅	yff/
与法国	yfg/
应符合	yfh/
有非常	yfi/
优抚金	yfj/
预付款	yfk/
引发了	yfl/
一方面	yfm/
益肤宁	yfn/
依凡欧	yfo/
预分配	yfp/
一分钱	yfq/
与繁荣	yfr/
玉佛寺	yfs/
阎浮提	yft/
易发生	yfu/
与发展	yfv/
与服务	yfw/
与分析	yfx/
依附于	yfy/
一分子	yfz/
由公安	yga/
应该把	ygb/
一个词	ygc/
严格的	ygd/
雅戈尔	yge/
杨贵妃	ygf/
一个个	ygg/
应该会	ygh/
与工程	ygi/
与国际	ygj/
与顾客	ygk/
与管理	ygl/
一感冒	ygm/
与国内	ygn/
预告片	ygp/
已过期	ygq/
一个人	ygr/
与公司	ygs/
与沟通	ygt/
应该是	ygu/
也跟着	ygv/
与国外	ygw/
有关系	ygx/
一个月	ygy/
一个字	ygz/
也好啊	yha/
以后不	yhb/
沿海村	yhc/
有很多	yhd/
一会儿	yhe/
有回复	yhf/
银行股	yhg/
有很好	yhh/
有好处	yhi/
优惠价	yhj/
银行卡	yhk/
氧化铝	yhl/
用户名	yhm/
约翰尼	yhn/
又害怕	yhp/
有很强	yhq/
液化热	yhr/
银灰色	yhs/
宴会厅	yht/
印花税	yhu/
与会者	yhv/
以后我	yhw/
约翰逊	yhx/
银行业	yhy/
用户组	yhz/
乙醇胺	yia/
已初步	yib/
有差错	yic/
原产地	yid/
雨翅蛾	yie/
要充分	yif/
已成功	yig/
演唱会	yih/
一串串	yii/
有差距	yij/
一出口	yik/
预处理	yil/
一场梦	yim/
一刹那	yin/
一长排	yip/
有长期	yiq/
有出入	yir/
有出色	yis/
与传统	yit/
宜昌市	yiu/
演唱者	yiv/
已成为	yiw/
又重新	yix/
有创意	yiy/
有充足	yiz/
阴茎癌	yja/
已经被	yjb/
有几次	yjc/
一季度	yjd/
要劲儿	yje/
有机肥	yjf/
有几个	yjg/
一句话	yjh/
要坚持	yji/
与经济	yjj/
与健康	yjk/
要建立	yjl/
一进门	yjm/
遇见你	yjn/
尤吉欧	yjo/
液晶屏	yjp/
要加强	yjq/
一家人	yjr/
研究所	yjs/
与家庭	yjt/
也就是	yju/
研究者	yjv/
有机物	yjw/
要进行	yjx/
研究院	yjy/
已经在	yjz/
也卡啊	yka/
预科班	ykb/
洋快餐	ykc/
愉快的	ykd/
一块儿	yke/
与开发	ykf/
营口港	ykg/
与客户	ykh/
一开场	yki/
一口价	ykj/
一块块	ykk/
应考虑	ykl/
有空吗	ykm/
有可能	ykn/
一开盘	ykp/
遥控器	ykq/
一块肉	ykr/
迎客松	yks/
一卡通	ykt/
一开始	yku/
与控制	ykv/
优酷网	ykw/
以科学	ykx/
也可以	yky/
用筷子	ykz/
已立案	yla/
一览表	ylb/
一两次	ylc/
有力的	yld/
爷俩儿	yle/
医疗费	ylf/
有两个	ylg/
以良好	ylh/
一连串	yli/
养老金	ylj/
伊拉克	ylk/
迎来了	yll/
有礼貌	ylm/
一两年	yln/
袁隆平	ylp/
娱乐圈	ylq/
与利润	ylr/
有类似	yls/
伊兰特	ylt/
原来是	ylu/
有两种	ylv/
娱乐网	ylw/
营利性	ylx/
越来越	yly/
有来自	ylz/
郁闷啊	yma/
与目标	ymb/
莜麦菜	ymc/
优美的	ymd/
伊妹儿	yme/
有免费	ymf/
与美国	ymg/
雅马哈	ymh/
杨梅疮	ymi/
移民局	ymj/
衙门口	ymk/
淹没了	yml/
一幕幕	ymm/
以每年	ymn/
郁闷哦	ymo/
燕麦片	ymp/
羽毛球	ymq/
野蛮人	ymr/
亚麻酸	yms/
有媒体	ymt/
羊毛衫	ymu/
一秒钟	ymv/
有名望	ymw/
有明显	ymx/
也没有	ymy/
以满足	ymz/
以年爱	yna/
一年半	ynb/
野牛草	ync/
一年多	ynd/
义男儿	yne/
羊奶粉	ynf/
也能够	yng/
一年后	ynh/
月乃雏	yni/
一年级	ynj/
一乃葵	ynk/
有能力	ynl/
有那么	ynm/
一年内	ynn/
玉女派	ynp/
一年前	ynq/
有女人	ynr/
尤努斯	yns/
芋艿头	ynt/
云南省	ynu/
遇难者	ynv/
杨乃文	ynw/
有哪些	ynx/
与农业	yny/
药捻子	ynz/
与欧盟	yom/
印欧人	yor/
与欧洲	yov/
印欧语	yoy/
杨培安	ypa/
硬盘版	ypb/
一盘菜	ypc/
又跑到	ypd/
一盆儿	ype/
样品费	ypf/
与评估	ypg/
以配合	yph/
用品厂	ypi/
月平均	ypj/
月票卡	ypk/
预判了	ypl/
一匹马	ypm/
亚平宁	ypn/
与品牌	ypp/
杨浦区	ypq/
影评人	ypr/
优婆塞	yps/
与普通	ypt/
月偏食	ypu/
应聘者	ypv/
有品位	ypw/
音频线	ypx/
与朋友	ypy/
养盆栽	ypz/
有钱啊	yqa/
以确保	yqb/
油气藏	yqc/
一切都	yqd/
忆秦娥	yqe/
又缺乏	yqf/
由全国	yqg/
邀请函	yqh/
一起吃	yqi/
元器件	yqj/
一千克	yqk/
引起了	yql/
要全面	yqm/
与去年	yqn/
以欺骗	yqp/
一起去	yqq/
一群人	yqr/
邀请赛	yqs/
有其他	yqt/
尤其是	yqu/
与群众	yqv/
一起玩	yqw/
有缺陷	yqx/
与企业	yqy/
尤其在	yqz/
姚仁安	yra/
与日本	yrb/
也如此	yrc/
诱人的	yrd/
伊瑞尔	yre/
羽绒服	yrf/
有人管	yrg/
有任何	yrh/
羊肉串	yri/
愚人节	yrj/
有人看	yrk/
引入了	yrl/
由人民	yrm/
鄢睿男	yrn/
易燃品	yrp/
要认清	yrq/
也让人	yrr/
鱼肉松	yrs/
羊肉汤	yrt/
有人说	yru/
要认真	yrv/
也认为	yrw/
有韧性	yrx/
一日游	yry/
依然在	yrz/
意思啊	ysa/
压缩包	ysb/
腌酸菜	ysc/
有三大	ysd/
一丝儿	yse/
运算符	ysf/
有三个	ysg/
有丝毫	ysh/
有所长	ysi/
压缩机	ysj/
要思考	ysk/
以色列	ysl/
意思吗	ysm/
预算内	ysn/
野三坡	ysp/
隐私权	ysq/
优酸乳	ysr/
一丝丝	yss/
有三条	yst/
意思是	ysu/
有三种	ysv/
预算外	ysw/
严肃性	ysx/
有损于	ysy/
洋嗓子	ysz/
胰头癌	yta/
要特别	ytb/
益田村	ytc/
一听到	ytd/
英特尔	yte/
有天赋	ytf/
要通过	ytg/
研讨会	yth/
有突出	yti/
一条街	ytj/
一堂课	ytk/
一条龙	ytl/
与他们	ytm/
液态奶	ytn/
要听哦	yto/
有突破	ytp/
亚太区	ytq/
与他人	ytr/
有特色	yts/
一天天	ytt/
有特殊	ytu/
与挑战	ytv/
以太网	ytw/
与同学	ytx/
有同样	yty/
与投资	ytz/
也是啊	yua/
用鼠标	yub/
与上次	yuc/
意识到	yud/
言声儿	yue/
由双方	yuf/
一首歌	yug/
有时候	yuh/
以市场	yui/
艺术家	yuj/
袁世凯	yuk/
艺术类	yul/
有什么	yum/
与上年	yun/
也是哦	yuo/
艺术品	yup/
扬声器	yuq/
月收入	yur/
印刷所	yus/
艺术团	yut/
仪式上	yuu/
一生中	yuv/
衍生物	yuw/
要实现	yux/
要使用	yuy/
一是在	yuz/
一直按	yva/
一直被	yvb/
与政策	yvc/
严重的	yvd/
眼罩儿	yve/
由政府	yvf/
与中国	yvg/
与中华	yvh/
与支持	yvi/
邮政局	yvj/
优质课	yvk/
与质量	yvl/
验证码	yvm/
一周内	yvn/
一张牌	yvp/
渝中区	yvq/
有专人	yvr/
硬脂酸	yvs/
一整套	yvt/
一直是	yvu/
有这种	yvv/
与周围	yvw/
一致性	yvx/
要注意	yvy/
一直在	yvz/
因为爱	ywa/
英文版	ywb/
业务层	ywc/
以外的	ywd/
洋味儿	ywe/
也无法	ywf/
与我国	ywg/
有文化	ywh/
已完成	ywi/
源文件	ywj/
语文课	ywk/
与网络	ywl/
与我们	ywm/
因为你	ywn/
因为哦	ywo/
洋务派	ywp/
也完全	ywq/
义务人	ywr/
医务所	yws/
因为他	ywt/
因为是	ywu/
意味着	ywv/
因为我	yww/
意外险	ywx/
业务员	ywy/
与外资	ywz/
胰腺癌	yxa/
一下吧	yxb/
鱼腥草	yxc/
有效的	yxd/
一小儿	yxe/
与消费	yxf/
有相关	yxg/
也许会	yxh/
涌现出	yxi/
优先级	yxj/
一小块	yxk/
一系列	yxl/
与项目	yxm/
也许能	yxn/
印象派	yxp/
有效期	yxq/
有些人	yxr/
预选赛	yxs/
与系统	yxt/
也许是	yxu/
游戏中	yxv/
也希望	yxw/
有效性	yxx/
也需要	yxy/
一下子	yxz/
一眼啊	yya/
营业部	yyb/
有一次	yyc/
有一定	yyd/
营业额	yye/
医药费	yyf/
有一个	yyg/
音乐会	yyh/
越野车	yyi/
也已经	yyj/
有一块	yyk/
也有了	yyl/
有用吗	yym/
有一年	yyn/
愿意哦	yyo/
有一批	yyp/
由于其	yyq/
也有人	yyr/
有意思	yys/
有一天	yyt/
原因是	yyu/
有一种	yyv/
有一位	yyw/
有一些	yyx/
应用于	yyy/
应用在	yyz/
养藏獒	yza/
与资本	yzb/
又再次	yzc/
要做到	yzd/
鸭子儿	yze/
月租费	yzf/
有足够	yzg/
要做好	yzh/
易造成	yzi/
有自己	yzj/
以最快	yzk/
院子里	yzl/
又怎么	yzm/
又怎能	yzn/
硬座票	yzp/
以增强	yzq/
与自然	yzr/
羊杂碎	yzs/
又增添	yzt/
原则上	yzu/
原作者	yzv/
有作为	yzw/
应遵循	yzx/
与资源	yzy/
一座座	yzz/
自安村	zac/
最爱的	zad/
最昂贵	zag/
在安徽	zah/
在暗处	zai/
曾艾佳	zaj/
曾爱玲	zal/
做按摩	zam/
曾阿牛	zan/
在安排	zap/
在安全	zaq/
作案人	zar/
组氨酸	zas/
最爱他	zat/
做爱时	zau/
在安装	zav/
阻碍物	zaw/
棕矮星	zax/
在安阳	zay/
走啊走	zaz/
早坂爱	zba/
咱爸爸	zbb/
在本次	zbc/
在不断	zbd/
资本额	zbe/
在部分	zbf/
最宝贵	zbg/
在保护	zbh/
在保持	zbi/
在北京	zbj/
在博客	zbk/
在办理	zbl/
在北美	zbm/
总不能	zbn/
滋补品	zbp/
坐便器	zbq/
在别人	zbr/
在比赛	zbs/
在不同	zbt/
则表示	zbu/
总版主	zbv/
做不完	zbw/
则必须	zbx/
在毕业	zby/
暂不作	zbz/
曾厝垵	zca/
总裁班	zcb/
在此次	zcc/
子菜单	zcd/
在采访	zcf/
在采购	zcg/
早餐后	zch/
在此处	zci/
在参加	zcj/
在此刻	zck/
组策略	zcl/
最聪明	zcm/
早餐奶	zcn/
作此篇	zcp/
在此前	zcq/
最脆弱	zcr/
在厕所	zcs/
在餐厅	zct/
在此时	zcu/
增村镇	zcv/
在财务	zcw/
再次向	zcx/
则采用	zcy/
在操作	zcz/
在的啊	zda/
在东北	zdb/
最底层	zdc/
在当地	zdd/
走调儿	zde/
最低分	zdf/
在德国	zdg/
自动化	zdh/
在调查	zdi/
最低价	zdj/
在贷款	zdk/
做到了	zdl/
字段名	zdm/
在电脑	zdn/
自动炮	zdp/
在当前	zdq/
在担任	zdr/
在第四	zds/
在冬天	zdt/
在当时	zdu/
最大值	zdv/
在单位	zdw/
在大学	zdx/
自定义	zdy/
在电子	zdz/
在耳边	zeb/
总额度	zed/
罪恶感	zeg/
再恶化	zeh/
在二级	zej/
在二楼	zel/
做恶梦	zem/
做儿女	zen/
紫二乔	zeq/
做恶人	zer/
再而三	zes/
在儿童	zet/
在二十	zeu/
在二战	zev/
总额为	zew/
最恶心	zex/
造恶业	zey/
在儿子	zez/
最方便	zfb/
做饭菜	zfc/
在法定	zfd/
紫枫儿	zfe/
最丰富	zff/
在法国	zfg/
最繁华	zfh/
字符串	zfi/
坐飞机	zfj/
暂付款	zfk/
在法律	zfl/
在父母	zfm/
揍飞你	zfn/
再分配	zfp/
在父亲	zfq/
尊夫人	zfr/
在飞速	zfs/
在法庭	zft/
在发生	zfu/
在发展	zfv/
租房网	zfw/
在分析	zfx/
总费用	zfy/
最复杂	zfz/
子宫癌	zga/
最根本	zgb/
最高层	zgc/
在规定	zgd/
自个儿	zge/
最高峰	zgf/
在各个	zgg/
总工会	zgh/
在工程	zgi/
在国际	zgj/
在公开	zgk/
在管理	zgl/
在购买	zgm/
在国内	zgn/
在股票	zgp/
在过去	zgq/
在个人	zgr/
总公司	zgs/
在共同	zgt/
总干事	zgu/
在广州	zgv/
在国外	zgw/
最关心	zgx/
总共有	zgy/
在工作	zgz/
纵火案	zha/
最好不	zhb/
最后才	zhc/
在很多	zhd/
脏活儿	zhe/
在合肥	zhf/
在韩国	zhg/
最后还	zhh/
在何处	zhi/
在环境	zhj/
综合科	zhk/
做好了	zhl/
在后面	zhm/
最好能	zhn/
在和平	zhp/
在后期	zhq/
在韩日	zhr/
紫红色	zhs/
在合同	zht/
最好是	zhu/
综合征	zhv/
在海外	zhw/
综合性	zhx/
最好用	zhy/
最好在	zhz/
在长安	zia/
总承包	zib/
总持仓	zic/
在场的	zid/
早产儿	zie/
在充分	zif/
最成功	zig/
在窗户	zih/
造船厂	zii/
最常见	zij/
在窗口	zik/
造成了	zil/
在充满	zim/
在车内	zin/
在产品	zip/
走出去	ziq/
再插入	zir/
最出色	zis/
在传统	zit/
再尝试	ziu/
总产值	ziv/
则称为	ziw/
再重新	zix/
组成员	ziy/
再创造	ziz/
再见啊	zja/
最基本	zjb/
在基层	zjc/
增加到	zjd/
总金额	zje/
总经费	zjf/
自己干	zjg/
在今后	zjh/
自驾车	zji/
在经济	zjj/
再加快	zjk/
总经理	zjl/
字节码	zjm/
在今年	zjn/
在解剖	zjp/
再加强	zjq/
在进入	zjr/
总决赛	zjs/
在今天	zjt/
再加上	zju/
增加值	zjv/
在境外	zjw/
在进行	zjx/
再就业	zjy/
自己做	zjz/
最可爱	zka/
自考办	zkb/
总库存	zkc/
在看到	zkd/
在开发	zkf/
在客观	zkg/
在客户	zkh/
在考察	zki/
在科技	zkj/
再看看	zkk/
在考虑	zkl/
在昆明	zkm/
则可能	zkn/
最可怕	zkp/
在空气	zkq/
在快速	zks/
在课堂	zkt/
在考试	zku/
在空中	zkv/
自考网	zkw/
在科学	zkx/
则可以	zky/
钻空子	zkz/
走了啊	zla/
在路边	zlb/
在两次	zlc/
在伦敦	zld/
自留额	zle/
租赁房	zlf/
在两个	zlg/
最厉害	zlh/
在临床	zli/
在了解	zlj/
资料库	zlk/
紫罗兰	zll/
在里面	zlm/
在辽宁	zln/
走了哦	zlo/
资料片	zlp/
租赁期	zlq/
最令人	zlr/
在拉萨	zls/
在论坛	zlt/
自来水	zlu/
在兰州	zlv/
租赁物	zlw/
最理想	zlx/
坐落于	zly/
坐落在	zlz/
怎么啊	zma/
怎么办	zmb/
在每次	zmc/
在面对	zmd/
总名额	zme/
怎么发	zmf/
在每个	zmg/
怎么会	zmh/
在漫长	zmi/
总面积	zmj/
怎么看	zmk/
怎么了	zml/
在茫茫	zmm/
怎么能	zmn/
怎么跑	zmp/
在目前	zmq/
最迷人	zmr/
怎么算	zms/
在媒体	zmt/
怎么说	zmu/
在某种	zmv/
在门外	zmw/
在某些	zmx/
怎么样	zmy/
怎么做	zmz/
在哪啊	zna/
在内部	znb/
在农村	znc/
在内地	znd/
在哪儿	zne/
在南方	znf/
在那个	zng/
在脑后	znh/
在南昌	zni/
在南京	znj/
最难看	znk/
在那里	znl/
在你们	znm/
在南宁	znn/
灾难片	znp/
最年轻	znq/
在男人	znr/
枣泥酥	zns/
最难听	znt/
在那时	znu/
子女者	znv/
最难忘	znw/
在那些	znx/
在农业	zny/
在男子	znz/
遭殴打	zod/
择偶观	zog/
在欧美	zom/
在欧洲	zov/
在旁边	zpb/
曾沛慈	zpc/
在平等	zpd/
在谱儿	zpe/
在批发	zpf/
醉排骨	zpg/
再配合	zph/
在平常	zpi/
作品集	zpj/
在贫困	zpk/
最漂亮	zpl/
在屏幕	zpm/
在品牌	zpp/
最贫穷	zpq/
在平日	zpr/
最朴素	zps/
在普通	zpt/
在拍摄	zpu/
作品展	zpv/
在骗我	zpw/
在培训	zpx/
最便宜	zpy/
左撇子	zpz/
增强版	zqb/
在其次	zqc/
在确定	zqd/
足球儿	zqe/
在缺乏	zqf/
藏青果	zqg/
曾庆红	zqh/
在汽车	zqi/
作曲家	zqj/
曾秋坤	zqk/
增强了	zql/
最起码	zqm/
在去年	zqn/
最奇葩	zqp/
在全球	zqq/
在确认	zqr/
足球赛	zqs/
在其他	zqt/
在全省	zqu/
在其中	zqv/
最权威	zqw/
增强型	zqx/
在企业	zqy/
做妻子	zqz/
在日本	zrb/
自然村	zrc/
自然的	zrd/
自然风	zrf/
责任感	zrg/
自然会	zrh/
在日常	zri/
自然界	zrj/
总人口	zrk/
在人类	zrl/
在人民	zrm/
最热闹	zrn/
自然派	zrp/
在日前	zrq/
责任人	zrr/
自然色	zrs/
在人体	zrt/
自然是	zru/
责任制	zrv/
则认为	zrw/
责任心	zrx/
最容易	zry/
再融资	zrz/
走私案	zsa/
曾孙辈	zsb/
在速度	zsd/
在司法	zsf/
在三个	zsg/
在随后	zsh/
在四川	zsi/
增塑剂	zsj/
在思考	zsk/
总司令	zsl/
再扫描	zsm/
在三年	zsn/
赠送品	zsp/
在赛前	zsq/
自诉人	zsr/
在搜索	zss/
揍死他	zst/
总算是	zsu/
在苏州	zsv/
在死亡	zsw/
在思想	zsx/
在所有	zsy/
走私罪	zsz/
佐藤爱	zta/
在台北	ztb/
字体册	ztc/
在他的	ztd/
字帖儿	zte/
总统府	ztf/
在提高	ztg/
座谈会	zth/
最突出	zti/
在提交	ztj/
在天空	ztk/
增添了	ztl/
在他们	ztm/
在体内	ztn/
棕头鸥	zto/
在谈判	ztp/
在听取	ztq/
总投入	ztr/
在探索	zts/
最头疼	ztt/
总体上	ztu/
在调整	ztv/
在台湾	ztw/
在同学	ztx/
最讨厌	zty/
总投资	ztz/
佐山爱	zua/
暂时不	zub/
在首次	zuc/
自身的	zud/
走神儿	zue/
在双方	zuf/
在施工	zug/
在社会	zuh/
在市场	zui/
在世界	zuj/
最深刻	zuk/
走上了	zul/
做什么	zum/
在室内	zun/
在商品	zup/
在申请	zuq/
总收入	zur/
走绳索	zus/
资生堂	zut/
在上述	zuu/
在深圳	zuv/
总数为	zuw/
在实现	zux/
在使用	zuy/
总是在	zuz/
组织胺	zva/
组织部	zvb/
在这次	zvc/
最终的	zvd/
在这儿	zve/
在政府	zvf/
在中国	zvg/
在中华	zvh/
在这场	zvi/
最直接	zvj/
在这块	zvk/
在这里	zvl/
最著名	zvm/
在逐年	zvn/
在招聘	zvp/
自治区	zvq/
在众人	zvr/
在周四	zvs/
在整体	zvt/
增值税	zvu/
在这种	zvv/
早中晚	zvw/
在这些	zvx/
最重要	zvy/
在制造	zvz/
在玩啊	zwa/
在网吧	zwb/
最外层	zwc/
最伟大	zwd/
滋味儿	zwe/
在我方	zwf/
在我国	zwg/
组委会	zwh/
在完成	zwi/
在文件	zwj/
总务科	zwk/
在未来	zwl/
最完美	zwm/
最温暖	zwn/
则完全	zwq/
在微软	zwr/
最无私	zws/
作文题	zwt/
在网上	zwu/
在网站	zwv/
作为我	zww/
紫外线	zwx/
在午夜	zwy/
在文字	zwz/
在西安	zxa/
最新版	zxb/
遭雪藏	zxc/
在许多	zxd/
走形儿	zxe/
在西方	zxf/
在香港	zxg/
最喜欢	zxh/
自行车	zxi/
最先进	zxj/
仔细看	zxk/
在心里	zxl/
在项目	zxm/
在虚拟	zxn/
走下坡	zxp/
走下去	zxq/
最吓人	zxr/
自旋锁	zxs/
子系统	zxt/
在校生	zxu/
在寻找	zxv/
资讯网	zxw/
在学校	zxx/
则需要	zxy/
在选择	zxz/
罪与爱	zya/
再也不	zyb/
再一次	zyc/
左右的	zyd/
字眼儿	zye/
在依法	zyf/
做一个	zyg/
在以后	zyh/
在一场	zyi/
早已经	zyj/
资源库	zyk/
遭遇了	zyl/
座右铭	zym/
在一年	zyn/
在一旁	zyp/
在一起	zyq/
自由人	zyr/
总预算	zys/
在一天	zyt/
资源税	zyu/
在一种	zyv/
自以为	zyw/
在一些	zyx/
在医院	zyy/
在一座	zyz/
在资本	zzb/
在左侧	zzc/
脏脏的	zzd/
脏字儿	zze/
曾祖父	zzf/
最糟糕	zzg/
在最后	zzh/
总资产	zzi/
在自己	zzj/
走走看	zzk/
在走廊	zzl/
再怎么	zzm/
坐在那	zzn/
走资派	zzp/
在早期	zzq/
在昨日	zzr/
在昨天	zzt/
在自身	zzu/
在组织	zzv/
在昨晚	zzw/
自尊心	zzx/
在资源	zzy/
最早在	zzz/
