一	一
乙	乛
二	一一
十	一丨
丁	一丨
厂	一丿
七	一乛
卜	丨丶
八	丿ㄟ
人	丿ㄟ
入	丿ㄟ
儿	丿乛
匕	丿乛
几	丿乛
九	丿乛
刁	乛一
了	乛丨
刀	乛丿
力	乛丿
乃	乛丿
又	乛ㄟ
三	一二
干	一十
于	一一丨
亏	二乛
工	一丨一
土	十一
士	十一
才	一丨丿
下	一卜
寸	一丨丶
大	𠂇ㄟ
丈	一丿ㄟ
与	一乛一
万	一乛丿
上	丨一一
小	丨丿丶
口	丨乛一
山	丨凵
巾	丨乛丨
千	丿十
乞	丿一乛
川	丿丨丨
亿	亻乛
个	人丨
夕	丿乛丶
久	丿乛ㄟ
么	丿厶
勺	勹丶
凡	几丶
丸	丿乛丶
及	丿乛ㄟ
广	丶厂
亡	亠乛
门	丶丨乛
丫	丷丨
义	丶乂
之	丶乛ㄟ
尸	乛一丿
己	乛一乛
已	乛一乛
巳	乛一乛
弓	乛一乛
子	乛丨一
卫	卩一
也	乛丨乛
女	乛丿一
刃	刀丶
飞	乛丿丶
习	乛冫
叉	又丶
马	乛乛一
乡	乛乛丿
丰	一一一丨
王	一土
开	一廾
井	一一丿丨
天	一大
夫	一一丿ㄟ
元	二儿
无	一尢
云	二厶
专	一一乛丶
丐	一丨一乛
扎	扌乛
艺	艹乛
木	十丿ㄟ
五	一丨乛一
支	十又
厅	厂丁
不	一丿丨丶
犬	大丶
太	大丶
区	匚乂
历	厂力
歹	一夕
友	𠂇又
尤	尢丶
匹	匚儿
车	一乛一丨
巨	匚乛一
牙	一乛丨丿
屯	一乛丨乛
戈	一乛丿丶
比	比左匕
互	一乛乛一
切	七刀
瓦	一乛乛丶
止	丨一丨一
少	小丿
曰	囗一
日	囗一
中	丨乛一丨
贝	冂人
冈	冂乂
内	丨乛丿丶
水	丨乛丿ㄟ
见	冂见下
午	丿干
牛	丿一一丨
手	丿一一丨
气	丿一一乛
毛	丿一一乛
壬	丿士
升	丿廾
夭	丿大
长	丿一乛ㄟ
仁	亻二
什	亻十
片	丿丨一乛
仆	亻卜
化	亻匕
仇	亻九
币	丿巾
仍	亻乃
仅	亻又
斤	丿丿一丨
爪	丿丿丨ㄟ
反	丿丿又
介	人丿丨
父	八乂
从	人人
仑	人匕
今	人丶乛
凶	乂凵
分	八刀
乏	丿之
公	八厶
仓	人乛乛
月	冂一一
氏	丿乛一乛
勿	勹丿丿
欠	⺈人
风	几乂
丹	丿乛丶一
匀	勹冫
乌	丿乛乛一
勾	勹厶
凤	几又
六	亠八
文	亠乂
亢	亠几
方	丶万
火	丶丿人
为	丶丿乛丶
斗	丶丶十
忆	忄乛
计	讠十
订	讠丁
户	丶尸
认	讠人
冗	冖几
讥	讠几
心	丶乛丶丶
尺	尸ㄟ
引	弓丨
丑	乛丨一一
巴	巳丨
孔	子乛
队	阝人
办	力丿丶
以	乛丶人
允	厶儿
予	龴乛丨
邓	又阝
劝	又力
双	又又
书	乛乛丨丶
幻	幺乛
玉	王丶
刊	干刂
未	一一丨丿ㄟ
末	一一丨丿ㄟ
示	二小
击	一一丨凵
打	扌丁
巧	工一乛
正	一止
扑	扌卜
卉	十廾
扒	扌八
功	工力
扔	扌乃
去	土厶
甘	廿一
世	一丨丨一乛
艾	艹乂
古	十口
节	艹卩
本	一丨丿ㄟ一
术	木丶
可	丁口
丙	一内
左	𠂇工
厉	厂万
石	一丿口
右	𠂇口
布	𠂇巾
夯	大力
戊	戈丿
龙	𠂇匕丶
平	一丶丿十
灭	一火
轧	车乛
东	一乛丨丿丶
卡	上卜
北	丨一一匕
占	丨一口
凸	丨一丨乛一
卢	丨一尸
业	丨丨丶丿一
旧	丨日
帅	丨丿巾
归	丨丿彐
旦	日一
目	囗一一
且	丨乛一一一
叶	口十
甲	丨乛一一丨
申	丨乛一一丨
叮	口丁
电	丨乛一一乛
号	口一乛
田	囗十
由	丨乛一丨一
只	口八
叭	口八
史	丨乛一丿ㄟ
央	丨夬guài
兄	口儿
叽	口几
叼	口刁
叫	口乛丨
叩	口卩
叨	口刀
另	口力
叹	口又
冉	丨乛丨一一
皿	丨乛丨丨一
凹	丨乛丨乛一
囚	囗人
四	囗儿
生	丿龶
矢	丿天
失	丿夫
乍	丿一丨一一
禾	丿木
丘	丿丨一丨一
付	亻寸
仗	亻丈
代	亻弋
仙	亻山
们	亻门
仪	亻义
白	丿日
仔	亻子
他	亻也
斥	丿丿一丨丶
瓜	丿丿乛丶ㄟ
乎	丿丶丿一丨
丛	人人一
令	人丶龴
用	冂一一丨
甩	冂一一乛
印	丿乛一卩
尔	⺈小
乐	丿乛丨丿丶
句	勹口
匆	勹丿丿丶
册	丿乛丿乛一
卯	丿乛丿卩
犯	犭乛乛
外	夕卜
处	夂卜
冬	夂丶丶
鸟	乌丶
务	夂力
包	勹巳
饥	饣几
主	丶王
市	亠巾
立	亠丷一
冯	冫马
玄	亠幺
闪	门人
兰	丷三
半	丶丿一一丨
汁	氵十
汇	氵匚
头	丶丶大
汉	氵又
宁	宀丁
穴	宀八
它	宀匕
讨	讠寸
写	冖与
让	讠上
礼	礻乛
训	讠川
议	讠义
必	丶乛丶丿丶
讯	讠乛十
记	讠己
永	丶乛乛丿ㄟ
司	乛一口
尼	尸匕
民	乛一乛一乛
弗	乛一乛丿丨
弘	弓厶
出	乛丨丨凵
辽	辶了
奶	女乃
奴	女又
召	刀口
加	力口
皮	乛丿丨又
边	辶力
孕	乃子
发	乛丿又丶
圣	又土
对	又寸
台	厶口
矛	龴乛丨丿
纠	纟乛丨
母	乛乛丶一丶
幼	幺力
丝	乛乛乛乛一
邦	寿上阝
式	弋工
迂	辶于
刑	开刂
戎	戈𠂇
动	二厶力
扛	扌工
寺	土寸
吉	士口
扣	扌口
考	耂一乛
托	扌丿七
老	耂匕
巩	工凡
圾	土及
执	扌丸
扩	扌广
扫	扌彐
地	土也
场	土乛丿丿
扬	扌乛丿丿
耳	一丨丨一一一
芋	艹于
共	艹一八
芒	艹亡
亚	一业
芝	艹之
朽	木一乛
朴	木卜
机	木几
权	木又
过	辶寸
臣	匚丨乛一丨
吏	一丨乛一丿ㄟ
再	一冉
协	十办
西	一丨乛丿乛一
压	厂十一丶
厌	厂犬
戌	戊一
在	𠂇丨土
百	一白
有	𠂇月
存	𠂇丨子
而	一丿冂丨丨
页	一丿冂人
匠	匚斤
夸	大亏
夺	大寸
灰	𠂇火
达	辶大
列	歹刂
死	歹匕
成	戊乛
夹	一丶丿一丿ㄟ
夷	一乛一乛丿ㄟ
轨	车九
邪	牙阝
尧	一乛丿兀
划	戈刂
迈	辶万
毕	比左匕十
至	一厶土
此	止匕
贞	丨一冂人
师	丨丿一巾
尘	小土
尖	小大
劣	少力
光	⺌兀
当	⺌彐
早	日十
吁	口于
吐	口土
吓	口下
虫	中一丶
曲	丨乛一丨丨一
团	囗才
吕	口口
同	冂一口
吊	口巾
吃	口乞
因	囗大
吸	口及
吗	口马
吆	口幺
屿	山与
屹	山乞
岁	山夕
帆	巾凡
回	囗口
岂	山己
则	冂人刂
刚	冂乂刂
网	冂乂乂
肉	内人
年	丿一一丨一丨
朱	丿未
先	⺧儿
丢	丿土厶
廷	廴壬
舌	千口
竹	丿一丨丿一丨
迁	辶千
乔	夭丿丨
迄	辶乞
伟	亻韦
传	亻专
乒	丘丿
乓	丘丶
休	亻木
伍	亻五
伏	亻犬
优	亻尤
臼	丿丨一乛一一
伐	亻戈
延	廴丿丨一乛
仲	亻中
件	亻牛
任	亻壬
伤	亻丿一力
价	亻人丿丨
伦	亻人匕
份	亻八刀
华	亻匕十
仰	亻丿乛卩
仿	亻方
伙	亻火
伪	亻为
自	丿目
伊	亻尹
血	丿皿
向	丿冂口
似	亻乛丶人
后	丿丿一口
行	彳亍
舟	丿丿乛丶一丶
全	人王
会	人二厶
杀	乂朩
合	人一口
兆	儿冫丿丶
企	人止
众	人人人
爷	八乂卩
伞	人丶丿十
创	人乛乛刂
肌	月几
肋	月力
朵	几木
杂	九朩
危	⺈厂乛乛
旬	勹日
旨	匕日
旭	九日
负	⺈冂人
匈	勹乂凵
名	夕口
各	夂口
多	夕夕
争	⺈乛一一丨
色	⺈巴
壮	冫丨士
冲	冫中
妆	冫丨女
冰	冫水
庄	广土
庆	广大
亦	亠丿丨丿丶
刘	文刂
齐	文丿丨
交	亠八乂
衣	亠𧘇
次	冫⺈人
产	立丿
决	冫夬guài
亥	亠乛丿人
充	亠厶儿
妄	亡女
闭	门才
问	门口
闯	门马
羊	丷一一一丨
并	丷开
关	丷天
米	丶丿木
灯	火丁
州	丶丿丶丨丶丨
汗	氵干
污	氵亏
江	氵工
汛	氵乛十
池	氵也
汝	氵女
汤	氵乛丿丿
忙	忄亡
兴	⺍一八
宇	宀于
守	宀寸
宅	宀丿七
字	宀子
安	宀女
讲	讠井
讳	讠韦
军	冖车
讶	讠牙
许	讠午
讹	讠亻匕
论	讠人匕
讼	讠八厶
农	丶乛丿乛丿ㄟ
讽	讠几乂
设	讠几又
访	讠方
诀	讠夬guài
寻	彐寸
那	乛一一丿阝
迅	辶乛十
尽	尺丶丶
导	巳寸
异	巳廾
弛	弓也
孙	子小
阵	阝车
阳	阝日
收	乛丨攵
阶	阝人丿丨
阴	阝月
防	阝方
奸	女干
如	女口
妇	女彐
妃	女己
好	女子
她	女也
妈	女马
戏	又戈
羽	习习
观	又冂见下
欢	又⺈人
买	乛丶丶大
红	纟工
驮	马大
纤	纟千
驯	马川
约	纟勺
级	纟及
纪	纟己
驰	马也
纫	纟刃
巡	辶乛乛乛
寿	寿上寸
弄	王廾
麦	龶夂
玖	王久
玛	王马
形	开丿丿丿
进	辶井
戒	戈廾
吞	天口
远	辶二儿
违	辶韦
韧	韦刃
运	辶二厶
扶	扌夫
抚	扌无
坛	土二厶
技	扌十又
坏	土不
抠	扌匚乂
扰	扌尤
扼	扌厂乛乛
拒	扌巨
找	扌戈
批	扌比左匕
址	土止
扯	扌止
走	土丨一人
抄	扌少
贡	工冂人
汞	工水
坝	土冂人
攻	工攵
赤	土丿丨丿丶
折	扌斤
抓	扌爪
扳	扌丿丿又
抡	扌人匕
扮	扌八刀
抢	扌人乛乛
孝	耂子
坎	土⺈人
均	土勹冫
抑	扌丿乛卩
抛	扌九力
投	扌几又
坟	土文
坑	土亠几
抗	扌亠几
坊	土方
抖	扌丶丶十
护	扌户
壳	士冖几
志	士心
块	土夬guài
扭	扌丑
声	士乛丨一丿
把	扌巴
报	扌卩又
拟	扌乛丶人
却	土厶卩
抒	扌龴乛丨
劫	土厶力
芙	艹夫
芜	艹无
苇	艹韦
芽	艹牙
花	艹亻匕
芹	艹斤
芥	艹人丿丨
芬	艹八刀
苍	艹人乛乛
芳	艹方
严	亚丿
芦	艹户
芯	艹心
劳	艹冖力
克	十口儿
芭	艹巴
苏	艹办
杆	木干
杠	木工
杜	木土
材	木才
村	木寸
杖	木丈
杏	木口
杉	木丿丿丿
巫	工人人
极	木及
李	木子
杨	木乛丿丿
求	一丨冫丿ㄟ丶
甫	一丨乛一一丨丶
匣	匚甲
更	一丨乛一一丿ㄟ
束	一丨乛一丨丿ㄟ
吾	五口
豆	一口丷一
两	一丨乛丿丶丿丶
酉	西一
丽	一丨乛丶丨乛
医	匚矢
辰	厂二乛丿ㄟ
励	厂万力
否	不口
还	辶不
尬	尢人丿丨
歼	歹千
来	一丶丿一丨丿ㄟ
连	辶车
轩	车干
步	止丨丿丿
卤	丨一囗乂
坚	丨丨又土
肖	⺌月
旱	日干
盯	目丁
呈	口王
时	日寸
吴	口天
助	且力
县	且厶
里	丨乛一一丨一一
呆	口木
吱	口十又
吠	口犬
呕	口匚乂
园	囗二儿
旷	日广
围	囗韦
呀	口牙
吨	口屯
足	口丨一人
邮	由阝
男	田力
困	囗木
吵	口少
串	丨乛一丨乛一丨
员	口冂人
呐	口内
听	口斤
吟	口人丶乛
吩	口八刀
呛	口人乛乛
吻	口勿
吹	口⺈人
呜	口乌
吭	口亠几
吧	口巴
邑	口巴
吼	口子乛
囤	囗屯
别	口力刂
吮	口厶儿
岖	山匚乂
岗	山冂乂
帐	巾长
财	冂人才
针	钅十
钉	钅丁
牡	牛土
告	⺧口
我	丿一丨一乛丿丶
乱	千口乛
利	禾刂
秃	禾几
秀	禾乃
私	禾厶
每	丿一母
兵	丘八
估	亻十口
体	亻本
何	亻丁口
佐	亻𠂇工
佑	亻𠂇口
但	亻日一
伸	亻申
佃	亻田
作	亻乍
伯	亻白
伶	亻人丶龴
佣	亻用
低	亻氐
你	亻⺈小
住	亻主
位	亻立
伴	亻半
身	丿丨乛一一一丿
皂	白七
伺	亻乛一口
佛	亻弗
囱	丿囗夂
近	辶斤
彻	彳七刀
役	彳几又
返	辶丿丿又
余	人余下
希	乂𠂇巾
坐	人人土
谷	八人口
妥	丿⺍女
含	人丶乛口
邻	人丶龴阝
岔	八刀山
肝	月干
肛	月工
肚	月土
肘	月寸
肠	月乛丿丿
龟	⺈丨乛一一乛
甸	勹田
免	⺈丨乛一丿乛
狂	犭王
犹	犭尤
狈	犭冂人
角	⺈用
删	册刂
条	夂朩
彤	丹丿丿丿
卵	丿乛丶丿乛丨丶
灸	久火
岛	丿乛丶乛山
刨	勹巳刂
迎	辶丿乛卩
饭	饣丿丿又
饮	饣⺈人
系	丿幺小
言	亠一一口
冻	冫东
状	冫丨犬
亩	亠田
况	冫口儿
床	广木
库	广车
庇	广比左匕
疗	疒了
吝	文口
应	广⺍一
这	辶文
冷	冫人丶龴
庐	广户
序	广龴乛丨
辛	立十
弃	亠厶廾
冶	冫厶口
忘	亡心
闰	门王
闲	门木
间	门日
闷	门心
判	半刂
兑	丷口儿
灶	火土
灿	火山
灼	火勺
弟	丷乛一乛丨丿
汪	氵王
沐	氵木
沛	氵一丨乛丨
汰	氵太
沥	氵厂力
沙	氵少
汽	氵气
沃	氵夭
沦	氵人匕
汹	氵乂凵
泛	氵乏
沧	氵人乛乛
没	氵几又
沟	氵勹厶
沪	氵户
沈	氵丶乛丿乛
沉	氵冖几
沁	氵心
怀	忄不
忧	忄尤
忱	忄丶乛丿乛
快	忄夬guài
完	宀二儿
宋	宀木
宏	宀𠂇厶
牢	宀牛
究	宀八九
穷	宀八力
灾	宀火
良	丶艮
证	讠正
启	户口
评	讠平
补	衤卜
初	衤刀
社	礻土
祀	礻巳
识	讠口八
诈	讠乍
诉	讠斥
罕	冖八干
诊	讠人丿丿丿
词	讠乛一口
译	讠又一一丨
君	尹口
灵	彐火
即	即左卩
层	尸二厶
屁	尸比左匕
尿	尸水
尾	尸毛
迟	辶尺
局	尸乛口
改	己攵
张	弓长
忌	己心
际	阝二小
陆	阝击
阿	阝丁口
陈	阝东
阻	阝且
附	阝亻寸
坠	阝人土
妓	女十又
妙	女少
妖	女夭
姊	女丿乛丨丿
妨	女方
妒	女户
努	女又力
忍	刃心
劲	乛丶工力
矣	厶矢
鸡	又鸟
纬	纟韦
驱	马匚乂
纯	纟屯
纱	纟少
纲	纟冂乂
纳	纟内
驳	马乂乂
纵	纟人人
纷	纟八刀
纸	纟氏
纹	纟文
纺	纟方
驴	马户
纽	纟丑
奉	寿上ㄟ一一丨
玩	王二儿
环	王不
武	一弋止
青	龶月
责	龶冂人
现	王冂见下
玫	王攵
表	龶𧘇
规	夫冂见下
抹	扌末
卦	土土卜
坷	土丁口
坯	土丕
拓	扌石
拢	扌龙
拔	扌𠂇又丶
坪	土平
拣	扌一乛乛丿丶
坦	土日一
担	扌日一
坤	土申
押	扌甲
抽	扌由
拐	扌口力
拖	扌丿一也
者	耂日
拍	扌白
顶	丁一丿冂人
拆	扌斥
拎	扌人丶龴
拥	扌用
抵	扌氐
拘	扌勹口
势	扌丸力
抱	扌勹巳
拄	扌主
垃	土立
拉	扌立
拦	扌丷三
幸	土丷干
拌	扌半
拧	扌宀丁
拂	扌弗
拙	扌出
招	扌刀口
坡	土乛丿丨又
披	扌乛丿丨又
拨	扌乛丿又丶
择	扌又一一丨
抬	扌厶口
拇	扌母
拗	扌幺力
其	其上八
取	耳又
茉	艹末
苦	艹十口
昔	艹一日
苛	艹丁口
若	艹𠂇口
茂	艹戊
苹	艹平
苗	艹田
英	艹央
苟	艹勹口
苑	艹夕乛乛
苞	艹勹巳
范	艹氵乛乛
直	十具上
茁	艹出
茄	艹力口
茎	艹乛丶工
苔	艹厶口
茅	艹龴乛丨丿
枉	木王
林	木木
枝	木十又
杯	木不
枢	木匚乂
柜	木巨
枚	木攵
析	木斤
板	木丿丿又
松	木八厶
枪	木人乛乛
枫	木几乂
构	木勹厶
杭	木亠几
杰	木灬
述	辶术
枕	木丶乛丿乛
丧	十丶丿一乛丿ㄟ
或	戈口一
画	一田凵
卧	臣卜
事	一丨乛一乛一一丨
刺	一丨乛丨丿ㄟ刂
枣	一丨乛丨丿ㄟ丶丶
雨	一丨乛丨丶丶丶丶
卖	十乛丶丶大
郁	𠂇月阝
矾	石凡
矿	石广
码	石马
厕	厂冂人刂
奈	大二小
奔	大十廾
奇	大丁口
奋	大田
态	太心
欧	匚乂⺈人
殴	匚乂几又
垄	龙土
妻	一乛一一丨女
轰	车又又
顷	比左一丿冂人
转	车专
斩	车斤
轮	车人匕
软	车⺈人
到	一厶土刂
非	丨一一一丨一一一
叔	上小又
歧	止十又
肯	止月
齿	止人凵
些	止匕二
卓	丨一日十
虎	虍几
虏	虍力
肾	丨丨又月
贤	丨丨又冂人
尚	⺌冂口
旺	日王
具	具上八
味	口未
果	丨乛一一一丨丿ㄟ
昆	日比左匕
国	囗玉
哎	口艹乂
咕	口十口
昌	日日
呵	口丁口
畅	申乛丿丿
明	日月
易	日勿
咙	口龙
昂	日丿乛卩
迪	辶由
典	丨乛一丨丨一八
固	囗十口
忠	中心
呻	口申
咒	口口几
咋	口乍
咐	口亻寸
呼	口乎
鸣	口鸟
咏	口永
呢	口尸匕
咄	口出
咖	口力口
岸	山厂干
岩	山石
帖	巾丨一口
罗	罒夕
帜	巾口八
帕	巾白
岭	山人丶龴
凯	山己几
败	冂人攵
账	冂人长
贩	冂人丿丿又
贬	冂人乏
购	冂人勹厶
贮	冂人宀一
图	囗夂丶丶
钓	钅勺
制	丿一一丨乛丨刂
知	矢口
迭	辶失
氛	气八刀
垂	丿一丨一丨丨一一
牧	牛攵
物	牛勿
乖	千丨一一匕
刮	千口刂
秆	禾干
和	禾口
季	禾子
委	禾女
秉	丿一乛一一丨丿ㄟ
佳	亻土土
侍	亻土寸
岳	丘山
供	亻艹一八
使	亻吏
例	亻歹刂
侠	亻夹
侥	亻一乛丿兀
版	片丿丿又
侄	亻一厶土
侦	亻丨一冂人
侣	亻口口
侧	亻冂人刂
凭	亻壬几
侨	亻夭丿丨
佩	亻几一巾
货	亻匕冂人
侈	亻夕夕
依	亻亠𧘇
卑	丿丨乛一一丿十
的	白勺
迫	辶白
质	丿丿十冂人
欣	斤⺈人
征	彳正
往	彳主
爬	爪巴
彼	彳乛丿丨又
径	彳乛丶工
所	丿丿乛一斤
舍	人干口
金	人干丶丿一
刹	乂朩刂
命	人一口卩
肴	乂𠂇月
斧	八乂斤
爸	八乂巴
采	丿⺍木
觅	丿⺍冂见下
受	丿⺍冖又
乳	丿⺍子乛
贪	人丶乛冂人
念	人丶乛心
贫	八刀冂人
忿	八刀心
肤	月夫
肺	月一丨乛丨
肢	月十又
肿	月中
胀	月长
朋	月月
股	月几又
肮	月亠几
肪	月方
肥	月巴
服	月卩又
胁	月办
周	冂土口
昏	氏日
鱼	⺈田一
兔	⺈丨乛一丿乛丶
狐	犭瓜
忽	勿心
狗	犭勹口
狞	犭宀丁
备	夂田
饰	饣丿一巾
饱	饣勹巳
饲	饣乛一口
变	亠丨丨丿丶又
京	亠口小
享	亠口子
庞	广龙
店	广丨一口
夜	亠亻丿乛丶ㄟ
庙	广由
府	广亻寸
底	广氐
疟	疒一乛一
疙	疒乞
疚	疒久
剂	文丿丨刂
卒	亠人人十
郊	亠八乂阝
庚	广乛一一丿ㄟ
废	广乛丿又丶
净	冫⺈乛一一丨
盲	亡目
放	方攵
刻	亠乛丿人刂
育	亠厶月
氓	亡民
闸	门甲
闹	门亠巾
郑	丷天阝
券	龹刀
卷	龹乛乛
单	丷丨乛一一一丨
炬	火巨
炒	火少
炊	火⺈人
炕	火亠几
炎	火火
炉	火户
沫	氵末
浅	氵戋
法	氵土厶
泄	氵世
沽	氵十口
河	氵丁口
沾	氵丨一口
泪	氵目
沮	氵且
油	氵由
泊	氵白
沿	氵几口
泡	氵勹巳
注	氵主
泣	氵立
泞	氵宀丁
泻	氵冖与
泌	氵必
泳	氵永
泥	氵尸匕
沸	氵弗
沼	氵刀口
波	氵乛丿丨又
泼	氵乛丿又丶
泽	氵又一一丨
治	氵厶口
怔	忄正
怯	忄土厶
怖	忄𠂇巾
性	忄生
怕	忄白
怜	忄人丶龴
怪	忄又土
怡	忄厶口
学	⺍冖子
宝	宀玉
宗	宀二小
定	宀一丨一人
宠	宀龙
宜	宀且
审	宀申
宙	宀由
官	宀㠯
空	宀八工
帘	宀八巾
宛	宀夕乛乛
实	宀丶丶大
试	讠弋工
郎	丶即左阝
诗	讠土寸
肩	户月
房	户方
诚	讠成
衬	衤寸
衫	衤丿丿丿
视	礻冂见下
祈	礻斤
话	讠千口
诞	讠丿丨一乛廴
诡	讠⺈厂乛乛
询	讠勹日
该	讠亠乛丿人
详	讠羊
建	廴聿
肃	乛一一丨丿丨丿丶
录	彐氺
隶	乛一一丨冫丿ㄟ
帚	彐冖巾
屉	尸世
居	尸十口
届	尸由
刷	尸巾刂
屈	尸出
弧	弓瓜
弥	弓⺈小
弦	弓亠幺
承	乛丨一一一乛丿ㄟ
孟	子皿
陋	阝丙乛
陌	阝百
孤	子瓜
陕	阝夹
降	阝夂一乛丨
函	了冫丿丶凵
限	阝艮
妹	女未
姑	女十口
姐	女且
姓	女生
妮	女尸匕
始	女厶口
姆	女母
迢	辶刀口
驾	力口马
叁	厶大三
参	厶大丿丿丿
艰	又艮
线	纟戋
练	纟一乛乛丿丶
组	纟且
绅	纟申
细	纟田
驶	马史
织	纟口八
驹	马勹口
终	纟夂丶丶
驻	马主
绊	纟半
驼	马宀匕
绍	纟刀口
绎	纟又一一丨
经	纟乛丶工
贯	毌冂人
契	丰刀大
贰	弋二冂人
奏	寿上ㄟ天
春	寿上ㄟ日
帮	寿上阝巾
玷	王丨一口
珍	王人丿丿丿
玲	王人丶龴
珊	王册
玻	王乛丿丨又
毒	龶母
型	开刂土
拭	扌弋工
挂	扌土土
封	土土寸
持	扌土寸
拷	扌耂一乛
拱	扌艹一八
项	工一丿冂人
垮	土大亏
挎	扌大亏
城	土成
挟	扌夹
挠	扌一乛丿兀
政	正攵
赴	土丨一人卜
赵	土丨一人乂
挡	扌⺌彐
拽	扌曳
哉	十戈口
挺	扌壬廴
括	扌千口
垢	土丿丿一口
拴	扌人王
拾	扌人一口
挑	扌儿冫丿丶
垛	土几木
指	扌匕日
垫	扌丸土
挣	扌⺈乛一一丨
挤	扌文丿丨
拼	扌丷开
挖	扌宀八乛
按	扌宀女
挥	扌冖车
挪	扌乛一一丿阝
拯	扌了乛丿ㄟ一
某	甘木
甚	其上八乛
荆	艹开刂
茸	艹耳
革	廿丨乛一一丨
茬	艹𠂇丨土
荐	艹𠂇丨子
巷	艹一八巳
带	带上冖巾
草	艹日十
茧	艹虫
茵	艹囗大
茶	艹人朩
荒	艹亡丿丨乛
茫	艹氵亡
荡	艹氵乛丿丿
荣	艹冖木
荤	艹冖车
荧	艹冖火
故	十口攵
胡	十口月
荫	艹阝月
荔	艹力力力
南	十冂丷干
药	艹纟勺
标	木二小
栈	木戋
柑	木甘
枯	木十口
柄	木丙
栋	木东
相	木目
查	木日一
柏	木白
栅	木册
柳	木丿乛丿卩
柱	木主
柿	木亠巾
栏	木丷三
柠	木宀丁
树	木又寸
勃	十冖子力
要	西女
柬	一丨乛丶丿一丨丿ㄟ
咸	戌口
威	戌女
歪	不正
研	石开
砖	石专
厘	厂里
厚	厂日子
砌	石七刀
砂	石少
泵	石水
砚	石冂见下
砍	石⺈人
面	一丿囗丨丨一一
耐	而寸
耍	而女
牵	大冖牛
鸥	匚乂鸟
残	歹戋
殃	歹央
轴	车由
轻	车乛丶工
鸦	牙鸟
皆	比左匕白
韭	非一
背	丨一一匕月
战	丨一口戈
点	丨一口灬
虐	虍一乛一
临	丨丨丿一丶丨乛丨一
览	丨丨丿一丶冂见下
竖	丨丨又立
省	少目
削	⺌月刂
尝	⺌冖二厶
昧	日未
盹	目屯
是	日一丨一人
盼	目八刀
眨	目乏
哇	口土土
哄	口艹一八
哑	口亚
显	日业
冒	冂一一目
映	日央
星	日生
昨	日乍
咧	口歹刂
昭	日刀口
畏	田一乛丿ㄟ
趴	⻊八
胃	田月
贵	中一冂人
界	田人丿丨
虹	虫工
虾	虫下
蚁	虫义
思	田心
蚂	虫马
虽	口虫
品	口口口
咽	口囗大
骂	口口马
勋	口冂人力
哗	口亻匕十
咱	口自
响	口丿冂口
哈	口人一口
哆	口夕夕
咬	口亠八乂
咳	口亠乛丿人
咪	口米
哪	口乛一一丿阝
哟	口纟勺
炭	山𠂇火
峡	山夹
罚	罒讠刂
贱	冂人戋
贴	冂人丨一口
贻	冂人厶口
骨	丨乛乛冖月
幽	山幺幺
钙	钅丐
钝	钅屯
钞	钅少
钟	钅中
钢	钅冂乂
钠	钅内
钥	钅月
钦	钅⺈人
钧	钅勹冫
钩	钅勹厶
钮	钅丑
卸	午一丨一卩
缸	缶工
拜	龵一丰
看	龵目
矩	矢巨
毡	毛丨一口
氢	气乛丶工
怎	乍心
牲	牛生
选	辶⺧儿
适	辶千口
秒	禾少
香	禾日
种	禾中
秋	禾火
科	禾丶丶十
重	丿一丨乛一一丨一一
复	丿一日夂
竿	⺮干
段	丿丨一一一几又
便	亻更
俩	亻两
贷	亻弋冂人
顺	川一丿冂人
修	亻丨夂丿丿丿
俏	亻⺌月
保	亻口木
促	亻口丨一人
俄	亻我
俐	亻禾刂
侮	亻丿一母
俭	亻人一⺍一
俗	亻八人口
俘	亻丿⺍子
信	亻亠一一口
皇	白王
泉	白水
鬼	丿丨乛一一丿乛厶
侵	亻彐冖又
禹	丿丨乛一丨乛丨一丶
侯	亻乛一矢
追	辶丿㠯
俊	亻厶八夂
盾	丿丿十目
待	彳土寸
徊	彳囗口
衍	彳氵亍
律	彳聿
很	彳艮
须	丿丿丿一丿冂人
叙	人余下又
剑	人一⺍一刂
逃	辶儿冫丿丶
食	人良
盆	八刀皿
胚	月丕
胧	月龙
胆	月日一
胜	月生
胞	月勹巳
胖	月半
脉	月永
胎	月厶口
勉	⺈丨乛一丿乛力
狭	犭夹
狮	犭丨丿一巾
独	犭虫
狰	犭⺈乛一一丨
狡	犭亠八乂
狱	犭讠犬
狠	犭艮
贸	丿乛丶刀冂人
怨	夕乛乛心
急	⺈彐心
饵	饣耳
饶	饣一乛丿兀
蚀	饣虫
饺	饣亠八乂
饼	饣丷开
峦	亠丨丨丿丶山
弯	亠丨丨丿丶弓
将	冫丨夕寸
奖	冫丨夕大
哀	亠口𧘇
亭	亠口冖丁
亮	亠口冖几
度	广廿又
迹	辶亠丿丨丿丶
庭	广壬廴
疮	疒人乛乛
疯	疒几乂
疫	疒几又
疤	疒巴
咨	冫⺈人口
姿	冫⺈人女
亲	立朩
音	立日
帝	亠丷冖巾
施	方丿一也
闺	门土土
闻	门耳
闽	门虫
阀	门亻戈
阁	门夂口
差	⺶工
养	⺶ㄟ丿丨
美	⺷大
姜	⺷女
叛	半丿丿又
送	辶丷天
类	米大
迷	辶米
籽	米子
娄	米女
前	丷一月刂
首	丷一自
逆	辶丷一乛丨丿
兹	丷一幺幺
总	丷口心
炼	火一乛乛丿丶
炸	火乍
烁	火乐
炮	火勹巳
炫	火亠幺
烂	火丷三
剃	丷乛一乛丨丿刂
洼	氵土土
洁	氵士口
洪	氵艹一八
洒	氵西
柒	氵七木
浇	氵一乛丿兀
浊	氵虫
洞	氵冂一口
测	氵冂人刂
洗	氵⺧儿
活	氵千口
派	氵丿丿丿乛丿ㄟ
洽	氵人一口
染	氵九木
洛	氵夂口
浏	氵文刂
济	氵文丿丨
洋	氵羊
洲	氵州
浑	氵冖车
浓	氵农
津	氵聿
恃	忄土寸
恒	忄一日一
恢	忄𠂇火
恍	忄⺌兀
恬	忄千口
恤	忄血
恰	忄人一口
恼	忄亠乂凵
恨	忄艮
举	⺍一八一一丨
觉	⺍冖冂见下
宣	宀一日一
宦	宀臣
室	宀一厶土
宫	宀口口
宪	宀⺧儿
突	宀八犬
穿	宀八牙
窃	宀八七刀
客	宀夂口
诫	讠戈廾
冠	冖二儿寸
诬	讠工人人
语	讠五口
扁	户冂艹
袄	衤夭
祖	礻且
神	礻申
祝	礻口儿
祠	礻乛一口
误	讠口天
诱	讠禾乃
诲	讠丿一母
说	讠丷口儿
诵	讠龴用
垦	艮土
退	辶艮
既	即左一乛丿乛
屋	尸一厶土
昼	尺日一
屏	尸丷开
屎	尸米
费	弗冂人
陡	阝土丨一人
逊	辶子小
眉	乛丨一丿目
孩	子亠乛丿人
陨	阝口冂人
除	阝人余下
险	阝人一⺍一
院	阝宀二儿
娃	女土土
姥	女耂匕
姨	女夷
姻	女囗大
娇	女夭丿丨
姚	女儿冫丿丶
娜	女乛一一丿阝
怒	女又心
架	力口木
贺	力口冂人
盈	乃又皿
勇	龴用力
怠	厶口心
癸	乛丶丿丿ㄟ天
蚤	叉虫
柔	龴乛丨丿木
垒	厶厶厶土
绑	纟寿上阝
绒	纟戈𠂇
结	纟士口
绕	纟一乛丿兀
骄	马夭丿丨
绘	纟人二厶
给	纟人一口
绚	纟勹日
骆	马夂口
络	纟夂口
绝	纟⺈巴
绞	纟亠八乂
骇	马亠乛丿人
统	纟亠厶儿
耕	耒井
耘	耒二厶
耗	耒毛
耙	耒巴
艳	丰⺈巴
泰	寿上ㄟ氺
秦	寿上ㄟ禾
珠	王朱
班	王丶丿王
素	龶幺小
匿	匚艹𠂇口
蚕	天虫
顽	二儿一丿冂人
盏	戋皿
匪	匚非
捞	扌艹冖力
栽	十戈木
捕	扌甫
埂	土更
捂	扌五口
振	扌厂二乛丿ㄟ
载	十戈车
赶	土丨一人干
起	土丨一人己
盐	土卜皿
捎	扌⺌月
捍	扌日干
捏	扌日土
埋	土里
捉	扌口丨一人
捆	扌囗木
捐	扌口月
损	扌口冂人
袁	土口𧘇
捌	扌口力刂
都	耂日阝
哲	扌斤口
逝	辶扌斤
捡	扌人一⺍一
挫	扌人人土
换	扌⺈丨乛大
挽	扌⺈丨乛一丿乛
挚	扌丸手
热	扌丸灬
恐	工凡心
捣	扌丿乛丶乛山
壶	士冖业
捅	扌龴用
埃	土厶矢
挨	扌厶矢
耻	耳止
耿	耳火
耽	耳丶乛丿乛
聂	耳又又
恭	艹一八⺗
莽	艹犬廾
莱	艹来
莲	艹车辶
莫	艹日大
莉	艹禾刂
荷	艹亻丁口
获	艹犭犬
晋	亚日
恶	亚心
莹	艹冖玉
莺	艹冖鸟
真	十具上八
框	木匚王
梆	木寿上阝
桂	木土土
桔	木士口
栖	木西
档	木⺌彐
桐	木冂一口
株	木朱
桥	木夭丿丨
桦	木亻匕十
栓	木人王
桃	木儿冫丿丶
格	木夂口
桩	木广土
校	木亠八乂
核	木亠乛丿人
样	木羊
根	木艮
索	十冖幺小
哥	丁口丁口
速	辶束
逗	辶一口丷一
栗	西木
贾	西冂人
酌	酉勺
配	酉己
翅	十又习习
辱	厂二乛丿ㄟ寸
唇	厂二乛丿ㄟ口
夏	一自夂
砸	石匚巾
砰	石平
砾	石乐
础	石出
破	石乛丿丨又
原	厂白小
套	大一丨一二厶
逐	辶豕
烈	歹刂灬
殊	歹朱
殉	歹勹日
顾	厂乛乛一丿冂人
轿	车夭丿丨
较	车亠八乂
顿	屯一丿冂人
毙	比左匕歹匕
致	一厶土攵
柴	止匕木
桌	丨一日木
虑	虍心
监	丨丨丿一丶皿
紧	丨丨又幺小
党	⺌冖口儿
逞	辶口王
晒	日西
眠	目民
晓	日一乛丿兀
哮	口耂子
唠	口艹冖力
鸭	甲鸟
晃	日⺌兀
哺	口甫
晌	日丿冂口
剔	日勿刂
晕	日冖车
蚌	虫丰
畔	田半
蚣	虫八厶
蚊	虫文
蚪	虫丶丶十
蚓	虫弓丨
哨	口⺌月
哩	口里
圃	囗甫
哭	口口犬
哦	口我
恩	囗大心
鸯	央鸟
唤	口⺈丨乛大
唁	口亠一一口
哼	口亠口了
唧	口即左卩
啊	口阝丁口
唉	口厶矢
唆	口厶八夂
罢	罒土厶
峭	山⺌月
峨	山我
峰	山夂丰
圆	囗口冂人
峻	山厶八夂
贼	冂人戈𠂇
贿	冂人𠂇月
赂	冂人夂口
赃	冂人广土
钱	钅戋
钳	钅甘
钻	钅丨一口
钾	钅甲
铁	钅失
铃	钅人丶龴
铅	钅几口
缺	缶夬
氧	气羊
氨	气宀女
特	牛土寸
牺	牛西
造	辶⺧口
乘	千丨一一匕丿ㄟ
敌	千口攵
秤	禾平
租	禾且
积	禾口八
秧	禾央
秩	禾失
称	禾⺈小
秘	禾必
透	辶禾乃
笔	⺮毛
笑	⺮夭
笋	⺮尹
债	亻龶冂人
借	亻艹一日
值	亻十具上
倚	亻大丁口
俺	亻大电
倾	亻比左一丿冂人
倒	亻一厶土刂
倘	亻⺌冂口
俱	亻具上八
倡	亻日日
候	亻丨乛一矢
赁	亻壬冂人
俯	亻广亻寸
倍	亻立口
倦	亻龹乛乛
健	亻聿廴
臭	自犬
射	身寸
躬	身弓
息	自心
倔	亻尸出
徒	彳土丨一人
徐	彳人余下
殷	丿丿彐乛几又
舰	舟冂见下
舱	舟人乛乛
般	舟几又
航	舟亠几
途	辶人余下
拿	人一口手
耸	人人耳
爹	八乂夕夕
舀	丿⺍臼
爱	丿⺍冖𠂇又
豺	豸才
豹	豸勺
颁	八刀一丿冂人
颂	八厶一丿冂人
翁	八厶习习
胰	月夷
脆	月⺈厂乛乛
脂	月匕日
胸	月勹乂凵
胳	月夂口
脏	月广土
脐	月文丿丨
胶	月亠八乂
脑	月亠乂凵
脓	月农
逛	辶犭王
狸	犭里
狼	犭良
卿	丿乛丿即左卩
逢	辶夂丰
鸵	鸟宀匕
留	丿乛丶刀田
鸳	夕乛乛鸟
皱	⺈彐乛丿丨又
饿	饣我
馁	饣丿⺍女
凌	冫土八夂
凄	冫一乛一一丨女
恋	亠丨丨丿丶心
桨	冫丨夕木
浆	冫丨夕水
衰	亠丨乛一一𧘇
衷	亠中𧘇
高	亠口冂口
郭	亠口子阝
席	广廿巾
准	冫亻亠龶
座	广人人土
症	疒正
病	疒丙
疾	疒矢
斋	文而
疹	疒人丿丿丿
疼	疒夂丶丶
疲	疒乛丿丨又
脊	冫丿丶人月
效	亠八乂攵
离	亠乂凵丨乛乛丶
紊	文幺小
唐	广乛一一丨口
瓷	冫⺈人瓦
资	冫⺈人冂人
凉	冫亠口小
站	立丨一口
剖	立口刂
竞	立口儿
部	立口阝
旁	亠丷冖方
旅	方丿一丿乛丿ㄟ
畜	亠幺田
阅	门丷口儿
羞	⺶丑
羔	⺷灬
瓶	丷开瓦
拳	龹手
粉	米八刀
料	米丶丶十
益	丷一八皿
兼	丷一乛一一丨丨丿ㄟ
烤	火耂一乛
烘	火艹一八
烦	火一丿冂人
烧	火一乛丿兀
烛	火虫
烟	火囗大
烙	火夂口
递	辶丷乛一乛丨丿
涛	氵寿上寸
浙	氵扌斤
涝	氵艹冖力
浦	氵甫
酒	氵酉
涉	氵止丨丿丿
消	氵⺌月
涡	氵口内
浩	氵⺧口
海	氵丿一母
涂	氵人余下
浴	氵八人口
浮	氵丿⺍子
涣	氵⺈丨乛大
涤	氵夂朩
流	氵亠厶丿丨乛
润	氵门王
涧	氵门日
涕	氵丷乛一乛丨丿
浪	氵良
浸	氵彐冖又
涨	氵弓长
烫	氵乛丿丿火
涩	氵刃止
涌	氵龴用
悖	忄十冖子
悟	忄五口
悄	忄⺌月
悍	忄日干
悔	忄丿一母
悯	忄门文
悦	忄丷口儿
害	宀丰口
宽	宀艹冂见下
家	宀豕
宵	宀⺌月
宴	宀日女
宾	宀丘八
窍	宀八工一乛
窄	宀八乍
容	宀八人口
宰	宀立十
案	宀女木
请	讠龶月
朗	丶即左月
诸	讠耂日
诺	讠艹𠂇口
读	讠十乛丶丶大
扇	户习习
诽	讠非
袜	衤末
袖	衤由
袍	衤勹巳
被	衤乛丿丨又
祥	礻羊
课	讠果
冥	冖日亠八
谁	讠亻亠龶
调	讠冂土口
冤	冖⺈丨乛一丿乛丶
谅	讠亠口小
谆	讠亠口子
谈	讠火火
谊	讠宀且
剥	彐氺刂
恳	艮心
展	尸艹一乛丿ㄟ
剧	尸十口刂
屑	尸⺌月
弱	弓冫弓冫
陵	阝土八夂
祟	出二小
陶	阝勹缶
陷	阝⺈臼
陪	阝立口
娱	女口天
娟	女口月
恕	女口心
娥	女我
娘	女良
通	辶龴用
能	厶月匕匕
难	又亻亠龶
预	龴乛丨一丿冂人
桑	又又又木
绢	纟口月
绣	纟禾乃
验	马人一⺍一
继	纟米乛
骏	马厶八夂
球	王求
琐	王⺌冂人
理	王里
琉	王亠厶丿丨乛
琅	王良
捧	扌寿上ㄟ一一丨
堵	土耂日
措	扌艹一日
描	扌艹田
域	土戈口一
捺	扌大二小
掩	扌大电
捷	扌一乛一一丨一人
排	扌非
焉	正一乛灬
掉	扌丨一日十
捶	扌垂
赦	土丿丨丿丶攵
堆	土亻亠龶
推	扌亻亠龶
埠	土丿㠯十
掀	扌斤⺈人
授	扌丿⺍冖又
捻	扌人丶乛心
教	耂子攵
掏	扌勹缶
掐	扌⺈臼
掠	扌亠口小
掂	扌广丨一口
培	土立口
接	扌立女
掷	扌丷天阝
控	扌宀八工
探	扌冖八木
据	扌尸十口
掘	扌尸出
掺	扌厶大丿丿丿
职	耳口八
基	其上八土
聆	耳人丶龴
勘	其上八乛力
聊	耳丿乛丿卩
娶	耳又女
著	艹耂日
菱	艹土八夂
勒	革力
黄	艹一由八
菲	艹非
萌	艹日月
萝	艹罒夕
菌	艹囗禾
萎	艹禾女
菜	艹丿⺍木
萄	艹勹缶
菊	艹勹米
菩	艹立口
萍	艹氵平
菠	艹氵乛丿丨又
萤	艹冖虫
营	艹冖口口
乾	十日十乞
萧	艹肃
萨	艹阝产
菇	艹女十口
械	木戈廾
彬	木木丿丿丿
梦	木木夕
婪	木木女
梗	木更
梧	木五口
梢	木⺌月
梅	木丿一母
检	木人一⺍一
梳	木亠厶丿丨乛
梯	木丷乛一乛丨丿
桶	木龴用
梭	木厶八夂
救	求攵
曹	一丨乛一丨丨一日
副	一口田刂
票	西二小
酝	酉二厶
酗	酉乂凵
厢	厂木目
戚	戊上小
硅	石土土
硕	石一丿冂人
奢	大耂日
盔	𠂇火皿
爽	大乂乂乂乂
聋	龙耳
袭	龙亠𧘇
盛	成皿
匾	匚户冂艹
雪	雨彐
辅	车甫
辆	车两
颅	丨一尸一丿冂人
虚	虍业
彪	虍几丿丿丿
雀	少丨亠龶
堂	⺌冖口土
常	⺌冖口巾
眶	目匚王
匙	日一丨一人匕
晨	日厂二乛丿ㄟ
睁	目⺈乛一一丨
眯	目米
眼	目艮
悬	且厶心
野	里龴乛丨
啪	口扌白
啦	口扌立
曼	日罒又
晦	日丿一母
晚	日⺈丨乛一丿乛
啄	口一丿乛丿丿丶丿ㄟ
啡	口非
距	⻊巨
趾	⻊止
啃	口止月
跃	⻊夭
略	田夂口
蚯	虫丘
蛀	虫主
蛇	虫宀匕
唬	口虍几
累	田幺小
鄂	口口亏阝
唱	口日日
患	串心
啰	口罒夕
唾	口垂
唯	口亻亠龶
啤	口丿丨乛一一丿十
啥	口人干口
啸	口肃
崖	山厂土土
崎	山大丁口
崭	山车斤
逻	辶罒夕
崔	山亻亠龶
帷	巾亻亠龶
崩	山月月
崇	山宀二小
崛	山尸出
婴	冂人冂人女
圈	囗龹乛乛
铐	钅耂一乛
铛	钅⺌彐
铝	钅口口
铜	钅冂一口
铭	钅夕口
铲	钅产
银	钅艮
矫	矢夭丿丨
甜	千口甘
秸	禾士口
梨	禾刂木
犁	禾刂牛
秽	禾山夕
移	禾夕夕
笨	⺮本
笼	⺮龙
笛	⺮由
笙	⺮生
符	⺮亻寸
第	⺮乛一乛丨丿
敏	丿一母攵
做	亻十口攵
袋	亻弋亠𧘇
悠	亻丨攵心
偿	亻⺌冖二厶
偶	亻禺
偎	亻田一乛丿ㄟ
偷	亻人一月刂
您	亻⺈小心
售	亻亠龶口
停	亻亠口冖丁
偏	亻户冂艹
躯	身匚乂
兜	丿乛白乛一儿
假	亻乛一丨一一乛一又
衅	血半
徘	彳非
徙	彳止丨一人
得	彳日一寸
衔	彳钅亍
盘	舟皿
舶	舟白
船	舟几口
舵	舟宀匕
斜	人余下丶丶十
盒	人一口皿
鸽	人一口鸟
敛	人一⺍一攵
悉	丿米心
欲	八人口⺈人
彩	丿⺍木丿丿丿
领	人丶龴一丿冂人
脚	月土厶卩
脖	月十冖子
脯	月甫
豚	月豕
脸	月人一⺍一
脱	月丷口儿
象	⺈丨乛一丿乛丿丿丿ㄟ
够	勹口夕夕
逸	辶⺈丨乛一丿乛丶
猜	犭龶月
猪	犭耂日
猎	犭艹一日
猫	犭艹田
凰	几白王
猖	犭日日
猛	犭子皿
祭	丿乛丶丶二小
馅	饣⺈臼
馆	饣宀㠯
凑	冫寿上ㄟ天
减	冫戌口
毫	亠口冖毛
烹	亠口了灬
庶	广廿灬
麻	广木木
庵	广大电
痊	疒人王
痒	疒羊
痕	疒艮
廊	广丶即左阝
康	广乛一一丨冫丿ㄟ
庸	广乛一一丨乛一一丨
鹿	广乛丨丨一比左匕
盗	冫⺈人皿
章	立日十
竟	立日儿
商	亠丷冂八口
族	方丿一矢
旋	方丿一乛丨一人
望	亡月王
率	亠幺冫丿丶十
阎	门⺈臼
阐	门丷丨乛一一一丨
着	⺶目
羚	⺶人丶龴
盖	⺷皿
眷	龹目
粘	米丨一口
粗	米且
粒	米立
断	米乛斤
剪	丷一月刂刀
兽	丷田一口
焊	火日干
焕	火⺈丨乛大
清	氵龶月
添	氵天⺗
鸿	氵工鸟
淋	氵木木
涯	氵厂土土
淹	氵大电
渠	氵巨木
渐	氵车斤
淑	氵上小又
淌	氵⺌冂口
混	氵日比左匕
淮	氵亻亠龶
淆	氵乂𠂇月
渊	氵丿米丨
淫	氵丿⺍壬
渔	氵鱼
淘	氵勹缶
淳	氵亠口子
液	氵亠亻丿乛丶ㄟ
淤	氵方人丶丶
淡	氵火火
淀	氵宀一丨一人
深	氵冖八木
涮	氵尸巾刂
涵	氵了冫丿丶凵
婆	氵乛丿丨又女
梁	氵刀丿丶木
渗	氵厶大丿丿丿
情	忄龶月
惜	忄艹一日
惭	忄车斤
悼	忄丨一日十
惧	忄具上八
惕	忄日勿
惟	忄亻亠龶
惊	忄亠口小
惦	忄广丨一口
悴	忄亠人人十
惋	忄宀夕乛乛
惨	忄厶大丿丿丿
惯	忄毌冂人
寇	宀二儿丨一又
寅	宀一由八
寄	宀大丁口
寂	宀上小又
宿	宀亻百
窒	宀八一厶土
窑	宀八缶
密	宀必山
谋	讠甘木
谍	讠世木
谎	讠艹亡丿丨乛
谐	讠比左匕白
袱	衤亻犬
祷	礻寿上寸
祸	礻口内
谓	讠田月
谚	讠产丿丿丿
谜	讠米辶
逮	辶乛一一丨冫丿ㄟ
敢	乛耳攵
尉	尸二小寸
屠	尸耂日
弹	弓丷丨乛一一一丨
隋	阝𠂇工月
堕	阝𠂇月土
随	阝𠂇月辶
蛋	乛丨一人虫
隅	阝禺
隆	阝夂一生
隐	阝⺈彐心
婚	女氏日
婶	女宀申
婉	女宀夕乛乛
颇	乛丿丨又一丿冂人
颈	乛丶工一丿冂人
绩	纟龶冂人
绪	纟耂日
续	纟十乛丶丶大
骑	马大丁口
绰	纟丨一日十
绳	纟口电
维	纟亻亠龶
绵	纟白巾
绷	纟月月
绸	纟冂土口
综	纟宀二小
绽	纟宀一丨一人
绿	纟彐氺
缀	纟又又又又
巢	乛乛乛果
琴	王王人丶乛
琳	王木木
琢	王一丿乛丿丿丶丿ㄟ
琼	王亠口小
斑	王文王
替	夫夫日
揍	扌寿上ㄟ天
款	士二小⺈人
堪	土其上八乛
塔	土艹人一口
搭	扌艹人一口
堰	土匚日女
揩	扌比左匕白
越	土丨一人戈乛
趁	土丨一人人丿丿丿
趋	土丨一人⺈彐
超	土丨一人刀口
揽	扌丨丨丿一丶冂见下
堤	土日一丨一人
提	扌日一丨一人
博	十甫寸
揭	扌日勹人乛
喜	士口丷一口
彭	士口丷一丿丿丿
揣	扌山而
插	扌千臼
揪	扌禾火
搜	扌丿丨一乛一一丨又
煮	耂日灬
援	扌丿⺍一𠂇又
搀	扌⺈丨乛一丿乛丶丶
裁	十戈亠𧘇
搁	扌门夂口
搓	扌⺶工
搂	扌米女
搅	扌⺍冖冂见下
壹	士冖一口丷一
握	扌尸一厶土
搔	扌叉虫
揉	扌龴乛丨丿木
斯	其上八斤
期	其上八月
欺	其上八⺈人
联	耳丷天
葫	艹十口月
散	艹一月攵
惹	艹𠂇口心
葬	艹歹匕廾
募	艹日大力
葛	艹日勹人乛
董	艹重
葡	艹勹甫
敬	艹勹口攵
葱	艹匆心
蒋	艹冫丨夕寸
蒂	艹亠丷冖巾
落	艹氵夂口
韩	十日十韦
朝	十日十月
辜	十口立十
葵	艹乛丶丿丿ㄟ天
棒	木寿上ㄟ一一丨
棱	木土八夂
棋	木其上八
椰	木耳阝
植	木十具上
森	木木木
焚	木木火
椅	木大丁口
椒	木上小又
棵	木果
棍	木日比左匕
椎	木亻亠龶
棉	木白巾
棚	木月月
棕	木宀二小
棺	木宀㠯
榔	木丶即左阝
椭	木阝𠂇月
惠	一丨乛一一丨一丶心
惑	戈口一心
逼	辶一口田
粟	西米
棘	一丨乛丨丿ㄟ一丨乛丨丿ㄟ
酣	酉甘
酥	酉禾
厨	厂一口丷一寸
厦	厂一自夂
硬	石更
硝	石⺌月
确	石⺈用
硫	石亠厶丿丨乛
雁	厂亻亻亠龶
殖	歹十具上
裂	歹刂亠𧘇
雄	𠂇厶亻亠龶
颊	夹一丿冂人
雳	雨厂力
暂	车斤日
雅	牙亻亠龶
翘	一乛丿兀习习
辈	非车
悲	非心
紫	止匕幺小
凿	业丷一十凵
辉	⺌兀冖车
敞	⺌冂口攵
棠	⺌冖口木
赏	⺌冖口冂人
掌	⺌冖口手
晴	日龶月
睐	目来
暑	日耂日
最	日耳又
晰	日木斤
量	日一里
鼎	目乛一丿丨一丨乛
喷	口十艹冂人
喳	口木日一
晶	日日日
喇	口束刂
遇	辶禺
喊	口戌口
遏	辶日勹人乛
晾	日亠口小
景	日亠口小
畴	田寿上寸
践	⻊戋
跋	⻊𠂇又丶
跌	⻊失
跑	⻊勹巳
跛	⻊乛丿丨又
遗	辶中一冂人
蛙	虫土土
蛛	虫朱
蜓	虫壬廴
蜒	虫丿丨一乛廴
蛤	虫人一口
喝	口日勹人乛
鹃	口月鸟
喂	口田一乛丿ㄟ
喘	口山而
喉	口亻乛一矢
喻	口人一月刂
啼	口亠丷冖巾
喧	口宀一日一
嵌	山甘⺈人
幅	巾一口田
帽	巾冂一一目
赋	冂人一弋止
赌	冂人耂日
赎	冂人十乛丶丶大
赐	冂人日勿
赔	冂人立口
黑	丨乛丶丿一丨一一灬
铸	钅寿上寸
铺	钅甫
链	钅车辶
销	钅⺌月
锁	钅⺌冂人
锄	钅且力
锅	钅口内
锈	钅禾乃
锋	钅夂丰
锌	钅立十
锐	钅丷口儿
甥	生田力
掰	龵八刀手
短	矢一口丷一
智	矢口日
氮	气火火
毯	毛火火
氯	气彐氺
鹅	我鸟
剩	千丨一一匕丿ㄟ刂
稍	禾⺌月
程	禾口王
稀	禾乂𠂇巾
税	禾丷口儿
筐	⺮匚王
等	⺮土寸
筑	⺮工凡
策	⺮一丨乛丨丿ㄟ
筛	⺮丨丿一巾
筒	⺮冂一口
筏	⺮亻戈
答	⺮人一口
筋	⺮月力
筝	⺮⺈乛一一丨
傲	亻龶乛丿攵
傅	亻甫寸
牌	片丿丨乛一一丿十
堡	亻口木土
集	亻亠龶木
焦	亻亠龶灬
傍	亻亠丷冖方
储	亻讠耂日
皓	白⺧口
皖	白宀二儿
粤	丿囗米一乛
奥	丿冂米大
街	彳土土亍
惩	彳正心
御	彳午一丨一卩
循	彳丿丿十目
艇	舟壬廴
舒	人干口龴乛丨
逾	辶人一月刂
番	丿米田
释	丿米又一一丨
禽	人亠乂凵丨乛乛丶
腊	月艹一日
脾	月丿丨乛一一丿十
腋	月亠亻丿乛丶ㄟ
腔	月宀八工
腕	月宀夕乛乛
鲁	鱼日
猩	犭日生
猬	犭田月
猾	犭骨
猴	犭亻乛一矢
惫	夂田心
然	丿乛丶丶犬灬
馈	饣中一冂人
馋	饣⺈丨乛一丿乛丶丶
装	冫丨士亠𧘇
蛮	亠丨丨丿丶虫
就	亠口小尤
敦	亠口子攵
斌	文一弋止
痘	疒一口丷一
痢	疒禾刂
痪	疒⺈丨乛大
痛	疒龴用
童	立里
竣	立厶八夂
阔	门氵千口
善	羊丷一口
翔	⺶习习
羡	⺷冫⺈人
普	丷亚日
粪	米艹一八
尊	丷酉寸
奠	丷酉大
道	辶丷一自
遂	辶丷豕
曾	丷囗⺌日
焰	火⺈臼
港	氵艹一八巳
滞	氵带上冖巾
湖	氵十口月
湘	氵木目
渣	氵木日一
渤	氵十冖子力
渺	氵目少
湿	氵日业
温	氵日皿
渴	氵日勹人乛
溃	氵中一冂人
溅	氵冂人戋
滑	氵骨
湃	氵龵一丰
渝	氵人一月刂
湾	氵亠丨丨丿丶弓
渡	氵广廿又
游	氵方丿一子
滋	氵丷一幺幺
渲	氵宀一日一
溉	氵即左一乛丿乛
愤	忄十艹冂人
慌	忄艹亡丿丨乛
惰	忄𠂇工月
愕	忄口口亏
愣	忄罒方
惶	忄白王
愧	忄鬼
愉	忄人一月刂
慨	忄即左一乛丿乛
割	宀丰口刂
寒	宀一一丨丨一八丶丶
富	宀一口田
寓	宀禺
窜	宀八串
窝	宀八口内
窖	宀八⺧口
窗	宀八丿囗夂
窘	宀八尹口
遍	辶户冂艹
雇	户亻亠龶
裕	衤八人口
裤	衤广车
裙	衤尹口
禅	礻丷丨乛一一一丨
禄	礻彐氺
谢	讠身寸
谣	讠丿⺍缶
谤	讠亠丷冖方
谦	讠丷一乛一一丨丨丿ㄟ
犀	尸氺牛
属	尸禹
屡	尸米女
强	弓口虫
粥	弓米弓
疏	乛止亠厶丿丨乛
隔	阝一口冂丷一丨
隙	阝小日小
隘	阝丷一八皿
媒	女甘木
絮	女口幺小
嫂	女丿丨一乛一一丨又
媚	女乛丨一丿目
婿	女乛丨一人月
登	乛丶丿丿ㄟ一口丷一
缅	纟面
缆	纟丨丨丿一丶冂见下
缉	纟口耳
缎	纟丿丨一一一几又
缓	纟丿⺍一𠂇又
缔	纟亠丷冖巾
缕	纟米女
骗	马户冂艹
编	纟户冂艹
骚	马叉虫
缘	纟乛乛豕
瑟	王王必
鹉	一弋止鸟
瑞	王山而
瑰	王鬼
瑙	王乛乛乛丿囗乂
魂	二厶鬼
肆	一丨一二厶聿
摄	扌耳又又
摸	扌艹日大
填	土十具上八
搏	扌甫寸
塌	土日习习
鼓	士口丷一十又
摆	扌罒土厶
携	扌亻亠龶乃
搬	扌舟几又
摇	扌丿⺍缶
搞	扌亠口冂口
塘	土广乛一一丨口
摊	扌又亻亠龶
聘	耳由一乛
斟	其上八乛丶丶十
蒜	艹二小二小
勤	廿丨乛一一一丨一力
靴	革亻匕
靶	革巴
鹊	艹一日鸟
蓝	艹丨丨丿一丶皿
墓	艹日大土
幕	艹日大巾
蓬	艹夂丰辶
蓄	艹亠幺田
蒲	艹氵甫
蓉	艹宀八人口
蒙	艹冖二丿乛丿丿丿ㄟ
蒸	艹了乛丿ㄟ一灬
献	十冂丷干犬
椿	木寿上ㄟ日
禁	木木二小
楚	木木乛丨一人
楷	木比左匕白
榄	木丨丨丿一丶冂见下
想	木目心
槐	木鬼
榆	木人一月刂
楼	木米女
概	木即左一乛丿乛
赖	束⺈冂人
酪	酉夂口
酬	酉州
感	戌口心
碍	石日一寸
碘	石丨乛一丨丨一八
碑	石丿丨乛一一丿十
碎	石亠人人十
碰	石丷亚
碗	石宀夕乛乛
碌	石彐氺
尴	尢丨丨丿一丶皿
雷	雨田
零	雨人丶龴
雾	雨夂力
雹	雨勹巳
辐	车一口田
辑	车口耳
输	车人一月刂
督	上小又目
频	止丨丿丿一丿冂人
龄	止人凵人丶龴
鉴	丨丨丿一丶金
睛	目龶月
睹	目耂日
睦	目土八土
瞄	目艹田
睫	目一乛一一丨一人
睡	目垂
睬	目丿⺍木
嗜	口耂匕日
鄙	口十囗口阝
嗦	口十冖幺小
愚	禺心
暖	日丿⺍一𠂇又
盟	日月皿
歇	日勹人乛⺈人
暗	日立日
暇	日乛一丨一一乛一又
照	日刀口灬
畸	田大丁口
跨	⻊大亏
跷	⻊一乛丿兀
跳	⻊儿冫丿丶
跺	⻊几木
跪	⻊⺈厂乛乛
路	⻊夂口
跤	⻊亠八乂
跟	⻊艮
遣	辶中一㠯
蜈	虫口天
蜗	虫口内
蛾	虫我
蜂	虫夂丰
蜕	虫丷口儿
嗅	口自犬
嗡	口八厶习习
嗓	口又又又木
署	罒耂日
置	罒十具上
罪	罒非
罩	罒丨一日十
蜀	罒勹虫
幌	巾日⺌兀
错	钅艹一日
锚	钅艹田
锡	钅日勿
锣	钅罒夕
锤	钅垂
锥	钅亻亠龶
锦	钅白巾
键	钅聿廴
锯	钅尸十口
锰	钅子皿
矮	矢禾女
辞	千口立十
稚	禾亻亠龶
稠	禾冂土口
颓	禾几一丿冂人
愁	禾火心
筹	⺮寿上寸
签	⺮人一⺍一
简	⺮门日
筷	⺮忄夬guài
毁	臼工几又
舅	臼田力
鼠	臼乛丶丶乛丶丶乛
催	亻山亻亠龶
傻	亻丿囗乂八夂
像	亻⺈丨乛一丿乛丿丿丿ㄟ
躲	身几木
魁	鬼丶丶十
衙	彳五口亍
微	彳山一几攵
愈	人一月刂心
遥	辶丿⺍缶
腻	月弋二冂人
腰	月西女
腥	月日生
腮	月田心
腹	月丿一日夂
腺	月白水
鹏	月月鸟
腾	月龹马
腿	月艮辶
鲍	鱼勹巳
猿	犭土口𧘇
颖	匕禾一丿冂人
触	⺈用虫
解	⺈用刀牛
煞	⺈彐攵灬
雏	⺈彐亻亠龶
馍	饣艹日大
馏	饣丿乛丶刀田
酱	冫丨夕酉
禀	亠囗口二小
痹	疒田一丿丨
廓	广亠口子阝
痴	疒矢口
痰	疒火火
廉	广丷一乛一一丨丨丿ㄟ
靖	立龶月
新	立朩斤
韵	立日勹冫
意	立日心
誊	龹亠一一口
粮	米良
数	米女攵
煎	丷一月刂灬
塑	丷一乛丨丿月土
慈	丷一幺幺心
煤	火甘木
煌	火白王
满	氵艹两
漠	氵艹日大
滇	氵十具上八
源	氵厂白小
滤	氵虍心
滥	氵丨丨丿一丶皿
滔	氵丿⺍臼
溪	氵丿⺍幺大
溜	氵丿乛丶刀田
漓	氵亠乂凵丨乛乛丶
滚	氵亠八厶𧘇
溢	氵丷一八皿
溯	氵丷一乛丨丿月
滨	氵宀丘八
溶	氵宀八人口
溺	氵弓冫弓冫
粱	氵刀丿丶米
滩	氵又亻亠龶
慎	忄十具上八
誉	⺍一八亠一一口
塞	宀一一丨丨一八土
寞	宀艹日大
窥	宀八夫冂见下
窟	宀八尸出
寝	宀冫丨彐冖又
谨	讠廿丨乛一一一丨一
褂	衤土土卜
裸	衤果
福	礻一口田
谬	讠习习人丿丿丿
群	尹口羊
殿	尸艹一八几又
辟	尸口立十
障	阝立日十
媳	女自心
嫉	女疒矢
嫌	女丷一乛一一丨丨丿ㄟ
嫁	女宀豕
叠	又又又冖且
缚	纟甫寸
缝	纟夂丰辶
缠	纟广里
缤	纟宀丘八
剿	乛乛乛果刂
静	龶月⺈乛一一丨
碧	王白石
璃	王亠乂凵丨乛乛丶
赘	龶乛丿攵冂人
熬	龶乛丿攵灬
墙	土十丶丿一囗口
墟	土虍业
嘉	士口丷一力口
摧	扌山亻亠龶
赫	土丿丨丿丶土丿丨丿丶
截	十戈亻亠龶
誓	扌斤亠一一口
境	土立日儿
摘	扌亠丷冂十口
摔	扌亠幺冫丿丶十
撇	扌丶丿丨乛丨丿丶攵
聚	耳又亻丿丿丿ㄟ
慕	艹日大⺗
暮	艹日大日
摹	艹日大手
蔓	艹日罒又
蔑	艹罒戍
蔡	艹丿乛丶丶二小
蔗	艹广廿灬
蔽	艹丶丿丨乛丨丿丶攵
蔼	艹讠日勹人乛
熙	匚丨口丨巳灬
蔚	艹尸二小寸
兢	十口儿十口儿
模	木艹日大
槛	木丨丨丿一丶皿
榴	木丿乛丶刀田
榜	木亠丷冖方
榨	木宀八乍
榕	木宀八人口
歌	丁口丁口⺈人
遭	辶一丨乛一丨丨一日
酵	酉耂子
酷	酉⺧口
酿	酉良
酸	酉厶八夂
碟	石世木
碱	石戌口
碳	石山𠂇火
磁	石丷一幺幺
愿	厂白小心
需	雨而
辖	车宀丰口
辗	车尸艹一乛丿ㄟ
雌	止匕亻亠龶
裳	⺌冖口亠𧘇
颗	果一丿冂人
瞅	目禾火
墅	里龴乛丨土
嗽	口束⺈人
踊	⻊龴用
蜻	虫龶月
蜡	虫艹一日
蝇	虫口电
蜘	虫矢口
蝉	虫丷丨乛一一一丨
嘛	口广木木
嘀	口亠丷冂十口
赚	冂人丷一乛一一丨丨丿ㄟ
锹	钅禾火
锻	钅丿丨一一一几又
镀	钅广廿又
舞	丿一一丨丨丨丨一夕一乛丨
舔	千口天⺗
稳	禾⺈彐心
熏	丿一丨乛丶丿一丨一一灬
箕	⺮其上八
算	⺮目廾
箩	⺮罒夕
管	⺮宀㠯
箫	⺮肃
舆	丿丨一一车乛一一一八
僚	亻大丶丿日小
僧	亻丷囗⺌日
鼻	自田一丿丨
魄	白鬼
魅	鬼未
貌	豸白儿
膜	月艹日大
膊	月甫寸
膀	月亠丷冖方
鲜	鱼羊
疑	匕矢龴乛丨一人
孵	卵丿⺍子
馒	饣日罒又
裹	亠果𧘇
敲	亠口冂口丨一又
豪	亠口冖豕
膏	亠口冖口月
遮	辶广廿灬
腐	广亻寸内人
瘩	疒艹人一口
瘟	疒日皿
瘦	疒丿丨一乛一一丨又
辣	立𠂇束
彰	立日十丿丿丿
竭	立日勹人乛
端	立山而
旗	方丿一其上八
精	米龶月
粹	米亠人人十
歉	丷一乛一一丨丨丿ㄟ⺈人
弊	丶丿丨乛丨丿丶攵廾
熄	火自心
熔	火宀八人口
煽	火户习习
潇	氵艹肃
漆	氵木人氺
漱	氵束⺈人
漂	氵西二小
漫	氵日罒又
滴	氵亠丷冂十口
漾	氵⺷永
演	氵宀一由八
漏	氵尸雨
慢	忄日罒又
慷	忄广乛一一丨冫丿ㄟ
寨	宀一一丨丨一八朩
赛	宀一一丨丨一八冂人
寡	宀一丿且八刀
察	宀丿乛丶丶二小
蜜	宀必虫
寥	宀习习人丿丿丿
谭	讠西日十
肇	户攵聿
褐	衤日勹人乛
褪	衤艮辶
谱	讠丷亚日
隧	阝丷豕辶
嫩	女束攵
翠	习习亠人人十
熊	厶月匕匕灬
凳	乛丶丿丿ㄟ一口丷一几
骡	马田幺小
缩	纟宀亻百
慧	丰丰彐心
撵	扌夫夫车
撕	扌其上八斤
撒	扌艹一月攵
撩	扌大丶丿日小
趣	土丨一人耳又
趟	土丨一人⺌冂口
撑	扌⺌冖口手
撮	扌日耳又
撬	扌毛毛毛
播	扌丿米田
擒	扌人亠乂凵丨乛乛丶
墩	土亠口子攵
撞	扌立里
撤	扌亠厶月攵
增	土丷囗⺌日
撰	扌巳巳艹一八
聪	耳丷口心
鞋	革土土
鞍	革宀女
蕉	艹亻亠龶灬
蕊	艹心心心
蔬	艹乛止亠厶丿丨乛
蕴	艹纟日皿
横	木艹一由八
槽	木一丨乛一丨丨一日
樱	木冂人冂人女
橡	木⺈丨乛一丿乛丿丿丿ㄟ
樟	木立日十
橄	木乛耳攵
敷	甫方攵
豌	一口丷一宀夕乛乛
飘	西二小几乂
醋	酉艹一日
醇	酉亠口子
醉	酉亠人人十
磕	石土厶皿
磊	石石石
磅	石亠丷冖方
碾	石尸艹一乛丿ㄟ
震	雨厂二乛丿ㄟ
霄	雨⺌月
霉	雨丿一母
瞒	目艹两
题	日一丨一人一丿冂人
暴	日艹一八氺
瞎	目宀丰口
嘻	口士口丷一口
嘶	口其上八斤
嘲	口十日十月
嘹	口大丶丿日小
影	日亠口小丿丿丿
踢	⻊日勿
踏	⻊水日
踩	⻊丿⺍木
踪	⻊宀二小
蝶	虫世木
蝴	虫十口月
蝠	虫一口田
蝎	虫日勹人乛
蝌	虫禾丶丶十
蝗	虫白王
蝙	虫户冂艹
嘿	口黑
嘱	口尸禹
幢	巾立里
墨	黑土
镇	钅十具上八
镐	钅亠口冂口
镑	钅亠丷冖方
靠	⺧口非
稽	禾尤匕日
稻	禾丿⺍臼
黎	禾勹丿人氺
稿	禾亠口冂口
稼	禾宀豕
箱	⺮木目
篓	⺮米女
箭	⺮丷一月刂
篇	⺮户冂艹
僵	亻一田一田一
躺	身⺌冂口
僻	亻尸口立十
德	彳十罒一心
艘	舟丿丨一乛一一丨又
膝	月木人氺
膛	月⺌冖口土
鲤	鱼里
鲫	鱼即左卩
熟	亠口子丸灬
摩	广木木手
褒	亠亻口木𧘇
瘪	疒自人匕
瘤	疒丿乛丶刀田
瘫	疒又亻亠龶
凛	冫亠囗口二小
颜	产丿丿丿一丿冂人
毅	立丿乛丿丿丿丶几又
糊	米十口月
遵	辶丷酉寸
憋	丶丿丨乛丨丿丶攵心
潜	氵夫夫日
澎	氵士口丷一丿丿丿
潮	氵十日十月
潭	氵西日十
鲨	氵少鱼
澳	氵丿冂米大
潘	氵丿米田
澈	氵亠厶月攵
澜	氵门柬
澄	氵乛丶丿丿ㄟ一口丷一
懂	忄艹重
憔	忄亻亠龶灬
懊	忄丿冂米大
憎	忄丷囗⺌日
额	宀夂口一丿冂人
翩	户冂艹习习
褥	衤厂二乛丿ㄟ寸
谴	讠中一㠯辶
鹤	丶乛丿丨亠龶鸟
憨	乛耳攵心
慰	尸二小寸心
劈	尸口立十刀
履	尸彳丿一日夂
豫	龴乛丨⺈丨乛一丿乛丿丿丿ㄟ
缭	纟大丶丿日小
撼	扌戌口心
擂	扌雨田
操	扌口口口木
擅	扌亠囗口日一
燕	廿口丨一一匕灬
蕾	艹雨田
薯	艹罒耂日
薛	艹丿㠯立十
薇	艹彳山一几攵
擎	艹勹口攵手
薪	艹立朩斤
薄	艹氵甫寸
颠	十具上八一丿冂人
翰	十日十人习习
噩	王口口口口
橱	木厂一口丷一寸
橙	木乛丶丿丿ㄟ一口丷一
橘	木龴乛丨丿冂八口
整	束攵正
融	一口冂丷一丨虫
瓢	西二小瓜
醒	酉日生
霍	雨亻亠龶
霎	雨立女
辙	车亠厶月攵
冀	丨一一匕田艹一八
餐	丨一夕又人良
嘴	口止匕⺈用
踱	⻊广廿又
蹄	⻊亠丷冖巾
蹂	⻊龴乛丨丿木
蟆	虫艹日大
螃	虫亠丷冖方
器	口口犬口口
噪	口口口口木
鹦	冂人冂人女鸟
赠	冂人丷囗⺌日
默	黑犬
黔	黑人丶乛
镜	钅立日儿
赞	⺧儿⺧儿冂人
穆	禾白少丿丿
篮	⺮丨丨丿一丶皿
篡	⺮目大厶
篷	⺮夂丰辶
篱	⺮亠乂凵丨乛乛丶
儒	亻雨而
邀	辶白方攵
衡	彳⺈田大亍
膨	月士口丷一丿丿丿
雕	冂土口亻亠龶
鲸	鱼亠口小
磨	广木木石
瘾	疒阝⺈彐心
瘸	疒力口内人
凝	冫匕矢龴乛丨一人
辨	立𠂇丶丿立十
辩	立𠂇讠立十
糙	米⺧口辶
糖	米广乛一一丨口
糕	米⺷灬
燃	火丿乛丶丶犬灬
濒	氵止丨丿丿一丿冂人
澡	氵口口口木
激	氵白方攵
懒	忄束⺈冂人
憾	忄戌口心
懈	忄⺈用刀牛
窿	宀八阝夂一生
壁	尸口立十土
避	辶尸口立十
缰	纟一田一田一
缴	纟白方攵
戴	十戈田艹一八
擦	扌宀丿乛丶丶二小
藉	艹耒艹一日
鞠	革勹米
藏	艹戊乛一丿臣
藐	艹豸白儿
檬	木艹冖二丿乛丿丿丿ㄟ
檐	木⺈厂八亠一一口
檀	木亠囗口日一
礁	石亻亠龶灬
磷	石米夕一乛丨
霜	雨木目
霞	雨乛一丨一一乛一又
瞭	目大丶丿日小
瞧	目亻亠龶灬
瞬	目丿⺍冖夕一乛丨
瞳	目立里
瞩	目尸禹
瞪	目乛丶丿丿ㄟ一口丷一
曙	日罒耂日
蹋	⻊日习习
蹈	⻊丿⺍臼
螺	虫田幺小
蟋	虫丿米心
蟀	虫亠幺冫丿丶十
嚎	口亠口冖豕
赡	冂人⺈厂八亠一一口
穗	禾一丨乛一一丨一丶心
魏	禾女鬼
簧	⺮艹一由八
簇	⺮方丿一矢
繁	丿一母攵幺小
徽	彳山一幺小攵
爵	丿⺍罒即左寸
朦	月艹冖二丿乛丿丿丿ㄟ
臊	月口口口木
鳄	鱼口口亏
癌	疒口口口山
辫	立𠂇纟立十
赢	亡口月冂人凡
糟	米一丨乛一丨丨一日
糠	米广乛一一丨冫丿ㄟ
燥	火口口口木
懦	忄雨而
豁	宀丰口八人口
臀	尸艹一八几又月
臂	尸口立十月
翼	习习田艹一八
骤	马耳又亻丿丿丿ㄟ
藕	艹耒禺
鞭	革亻更
藤	艹月龹氺
覆	西彳丿一日夂
瞻	目⺈厂八亠一一口
蹦	⻊山月月
嚣	口口一丿冂人口口
镰	钅广丷一乛一一丨丨丿ㄟ
翻	丿米田习习
鳍	鱼耂匕日
鹰	广亻亻亠龶鸟
瀑	氵日艹一八氺
襟	衤木木二小
璧	尸口立十玉
戳	习习亻亠龶戈
孽	艹丿㠯立十子
警	艹勹口攵亠一一口
蘑	艹广木木石
藻	艹氵口口口木
攀	木乂乂木大手
曝	日日艹一八氺
蹲	⻊丷酉寸
蹭	⻊丷囗⺌日
蹬	⻊乛丶丿丿ㄟ一口丷一
巅	山十具上八一丿冂人
簸	⺮其上八乛丿丨又
簿	⺮氵甫寸
蟹	⺈用刀牛虫
颤	亠囗口日一一丿冂人
靡	广木木非
癣	疒鱼羊
瓣	立𠂇瓜立十
羹	⺷灬⺷大
鳖	丶丿丨乛丨丿丶攵鱼
爆	火日艹一八氺
疆	弓土一田一田一
鬓	一丨一二厶丿丿丿宀丘八
壤	土亠口口一一丨丨一𧘇
馨	士乛丨一丿几又禾日
耀	⺌兀习习亻亠龶
躁	⻊口口口木
蠕	虫雨而
嚼	口丿⺍罒即左寸
嚷	口亠口口一一丨丨一𧘇
巍	山禾女鬼
籍	⺮耒艹一日
鳞	鱼米夕一乛丨
魔	广木木鬼
糯	米雨而
灌	氵艹口口亻亠龶
譬	尸口立十亠一一口
蠢	寿上ㄟ日虫虫
霸	雨革月
露	雨⻊夂口
霹	雨尸口立十
躏	⻊艹门亻亠龶
黯	黑立日
髓	骨𠂇工月辶
赣	立日十夂工冂人
囊	一丨乛一丨冖口口一一丨丨一𧘇
镶	钅亠口口一一丨丨一𧘇
瓤	亠口口一一丨丨一𧘇瓜
罐	缶艹口口亻亠龶
矗	十具上十具上十具上
乂	丿ㄟ
乜	乛乛
兀	一儿
弋	一乛丶
孑	乛丨一
孓	乛丨ㄟ
幺	乛厶
亓	二丿丨
韦	一一乛丨
廿	艹一
丏	一丨乛乛
卅	一丿丨丨
仄	厂人
厄	厂乛乛
仃	亻丁
仉	亻几
仂	亻力
兮	八一乛
刈	乂刂
爻	乂乂
卞	丶下
闩	门一
讣	讠卜
尹	乛一一丿
夬	乛一丿ㄟ
爿	乛丨一丿
毋	乛乛丿一
邗	干阝
邛	工阝
艽	艹九
艿	艹乃
札	木乛
叵	匚口
匝	匚巾
丕	不一
匜	匚也
劢	万力
卟	口卜
叱	口匕
叻	口力
仨	亻三
仕	亻士
仟	亻千
仡	亻乞
仫	亻么
仞	亻刃
卮	丿丿一乛乛
氐	氏丶
犰	犭九
刍	⺈彐
邝	广阝
邙	亡阝
汀	氵丁
讦	讠干
讧	讠工
讪	讠山
讫	讠乞
尻	尸九
阡	阝千
尕	乃小
弁	厶廾
驭	马又
匡	匚王
耒	丰丿ㄟ
玎	王丁
玑	王几
邢	开阝
圩	土于
圬	土亏
圭	土土
扦	扌千
圪	土乞
圳	土川
圹	土广
扪	扌门
圮	土己
圯	土巳
芊	艹千
芍	艹勺
芄	艹丸
芨	艹及
芑	艹己
芎	艹弓
芗	艹乡
亘	一日一
厍	厂车
夼	大川
戍	戊丶
尥	尢勺
乩	丨一口乛
旯	日九
曳	丨乛一一乛丿
岌	山及
屺	山己
凼	水凵
囡	囗女
钇	钅乛
缶	午凵
氘	气丿丨
氖	气乃
牝	牛匕
伎	亻十又
伛	亻匚乂
伢	亻牙
佤	亻瓦
仵	亻午
伥	亻长
伧	亻人乛乛
伉	亻亠几
伫	亻宀一
囟	丿囗乂
汆	入水
刖	月刂
夙	几歹
旮	九日
刎	勿刂
犷	犭广
犸	犭马
舛	夕一乛丨
凫	丿乛丶乛几
邬	乌阝
饧	饣乛丿丿
汕	氵山
汔	氵乞
汐	氵夕
汲	氵及
汜	氵巳
汊	氵叉
忖	忄寸
忏	忄千
讴	讠匚乂
讵	讠巨
祁	礻阝
讷	讠内
聿	乛一一一一丨
艮	彐乛丿ㄟ
厾	乛土厶
阱	阝井
阮	阝二儿
阪	阝丿丿又
丞	了乛丿ㄟ一
妁	女勺
牟	厶牛
纡	纟于
纣	纟寸
纥	纟乞
纨	纟丸
玕	王干
玙	王与
抟	扌专
抔	扌不
圻	土斤
坂	土丿丿又
坍	土丹
坞	土乌
抃	扌卞
抉	扌夬guài
㧐	扌又又
芫	艹二儿
邯	甘阝
芸	艹二厶
芾	艹一丨乛丨
苈	艹厂力
苣	艹巨
芷	艹止
芮	艹内
苋	艹冂见下
芼	艹毛
苌	艹长
苁	艹人人
芩	艹人丶乛
芪	艹氏
芡	艹⺈人
芟	艹几又
苄	艹卞
苎	艹宀一
苡	艹乛丶人
杌	木兀
杓	木勺
杞	木己
杈	木叉
忑	下心
孛	十冖子
邴	丙阝
邳	丕阝
矶	石几
奁	大匚乂
豕	一丿乛丿丿丿ㄟ
忒	弋心
欤	与⺈人
轫	车刃
迓	辶牙
邶	丨一一匕阝
忐	上心
卣	丨一囗乛一
邺	业阝
旰	日干
呋	口夫
呒	口无
呓	口艹乛
呔	口太
呖	口厂力
呃	口厂乛乛
旸	日乛丿丿
吡	口比左匕
町	田丁
虬	虫乛
呗	口冂人
吽	口牛
吣	口心
吲	口弓丨
帏	巾韦
岐	山十又
岈	山牙
岘	山冂见下
岑	山人丶乛
岚	山几乂
兕	凹儿
囵	囗人匕
囫	囗勿
钊	钅刂
钋	钅卜
钌	钅了
迕	辶午
氙	气山
氚	气川
牤	牛亡
佞	亻二女
邱	丘阝
攸	亻丨攵
佚	亻失
佝	亻勹口
佟	亻夂丶丶
佗	亻宀匕
伽	亻力口
彷	彳方
佘	人二小
佥	人一⺍一
孚	丿⺍子
豸	丿丶丶丿乛丿丿
坌	八刀土
肟	月亏
邸	氐阝
奂	⺈丨乛大
劬	勹口力
狄	犭火
狁	犭厶儿
鸠	九鸟
邹	⺈彐阝
饨	饣屯
饩	饣气
饪	饣壬
饫	饣夭
饬	饣丿一力
亨	亠口了
庑	广无
庋	广十又
疔	疒丁
疖	疒卩
肓	亡月
闱	门韦
闳	门𠂇厶
闵	门文
羌	⺶乛
炀	火乛丿丿
沣	氵丰
沅	氵二儿
沔	氵丏
沤	氵匚乂
沌	氵屯
沏	氵七刀
沚	氵止
汩	氵曰
汨	氵日
沂	氵斤
汾	氵八刀
沨	氵几乂
汴	氵卞
汶	氵文
沆	氵亠几
沩	氵为
泐	氵阝力
怃	忄无
怄	忄匚乂
忡	忄中
忤	忄午
忾	忄气
怅	忄长
忻	忄斤
忪	忄八厶
怆	忄人乛乛
忭	忄卞
忸	忄丑
诂	讠十口
诃	讠丁口
诅	讠且
诋	讠氐
诌	讠⺈彐
诏	讠刀口
诒	讠厶口
孜	子攵
陇	阝龙
陀	阝宀匕
陂	阝乛丿丨又
陉	阝乛丶工
妍	女开
妩	女无
妪	女匚乂
妣	女比左匕
妊	女壬
妗	女人丶乛
妫	女为
妞	女丑
姒	女乛丶人
妤	女龴乛丨
邵	刀口阝
劭	刀口力
刭	乛丶工刂
甬	龴用
邰	厶口阝
纭	纟二厶
纰	纟比左匕
纴	纟壬
纶	纟人匕
纾	纟龴乛丨
玮	王韦
玡	王牙
玭	王比左匕
玠	王人丿丨
玢	王八刀
玥	王月
玦	王夬guài
盂	于皿
忝	天⺗
匦	匚车九
坩	土甘
抨	扌平
拤	扌上卜
坫	土丨一口
拈	扌丨一口
垆	土丨一尸
抻	扌申
劼	士口力
拃	扌乍
拊	扌亻寸
坼	土斥
坻	土氐
㧟	扌氵匚
坨	土宀匕
坭	土尸匕
抿	扌民
坳	土幺力
耶	耳阝
苷	艹甘
苯	艹本
苤	艹丕
茏	艹龙
苫	艹丨一口
苜	艹目
苴	艹且
苒	艹冉
苘	艹冂口
茌	艹亻士
苻	艹亻寸
苓	艹人丶龴
茚	艹丿乛一卩
茆	艹丿乛丿卩
茑	艹鸟
茓	艹宀八
茔	艹冖土
茕	艹冖乛十
茀	艹弗
苕	艹刀口
枥	木厂力
枇	木比左匕
杪	木少
杳	木日
枧	木冂见下
杵	木午
枨	木长
枞	木人人
枋	木方
杻	木丑
杷	木巴
杼	木龴乛丨
矸	石干
砀	石乛丿丿
刳	大亏刂
奄	大电
瓯	匚乂瓦
殁	歹几又
郏	夹阝
轭	车厂乛乛
郅	一厶土阝
鸢	弋鸟
盱	目于
昊	日天
昙	日二厶
杲	日木
昃	日厂人
咂	口匚巾
呸	口丕
昕	日斤
昀	日勹冫
旻	日文
昉	日方
炅	日火
咔	口上卜
畀	田一丿丨
虮	虫几
咀	口且
呷	口甲
黾	口电
呱	口瓜
呤	口人丶龴
咚	口夂丶丶
咆	口勹巳
咛	口宀丁
呶	口女又
呣	口母
呦	口幺力
咝	口丝
岢	山丁口
岿	山丨丿彐
岬	山甲
岫	山由
帙	巾失
岣	山勹口
峁	山丿乛丿卩
刿	山夕刂
迥	辶冂口
岷	山民
剀	山己刂
帔	巾乛丿丨又
峄	山又一一丨
沓	水日
囹	囗人丶龴
罔	冂丷一亡
钍	钅土
钎	钅千
钏	钅川
钒	钅凡
钕	钅女
钗	钅叉
邾	朱阝
迮	辶乍
牦	牛毛
竺	⺮二
迤	辶丿一也
佶	亻士口
佬	亻耂匕
佰	亻百
侑	亻𠂇月
侉	亻大亏
臾	丿丨一乛一一丿ㄟ
岱	亻弋山
侗	亻冂一口
侃	亻口丿丨乛
侏	亻朱
侩	亻人二厶
佻	亻儿冫丿丶
佾	亻八月
侪	亻文丿丨
佼	亻亠八乂
佯	亻羊
侬	亻农
帛	白巾
阜	丿㠯十
侔	亻厶牛
徂	彳且
刽	人二厶刂
郄	乂𠂇厶阝
怂	人人心
籴	入米
瓮	八厶瓦
戗	人乛乛戈
肼	月井
䏝	月专
肽	月太
肱	月𠂇厶
肫	月屯
剁	几木刂
迩	辶⺈小
郇	勹日阝
狙	犭且
狎	犭甲
狍	犭勹巳
狒	犭弗
咎	夂卜口
炙	丿乛丶丶火
枭	丿乛丶乛木
饯	饣戋
饴	饣厶口
冽	冫歹刂
冼	冫⺧儿
庖	广勹巳
疠	疒万
疝	疒山
疡	疒乛丿丿
兖	亠八厶儿
妾	立女
劾	亠乛丿人力
炜	火韦
𬉼	火匚乂
炖	火屯
炘	火斤
炝	火人乛乛
炔	火夬guài
泔	氵甘
沭	氵术
泷	氵龙
泸	氵丨一尸
泱	氵央
泅	氵囗人
泗	氵囗儿
泠	氵人丶龴
泺	氵乐
泖	氵丿乛丿卩
泫	氵亠幺
泮	氵半
沱	氵宀匕
泯	氵民
泓	氵弓厶
泾	氵乛丶工
怙	忄十口
怵	忄术
怦	忄平
怛	忄日一
怏	忄央
怍	忄乍
㤘	忄⺈彐
怩	忄尸匕
怫	忄弗
怿	忄又一一丨
宕	宀石
穹	宀八弓
宓	宀必
诓	讠匚王
诔	讠耒
诖	讠土土
诘	讠士口
戾	户犬
诙	讠𠂇火
戽	户丶丶十
郓	冖车阝
衩	衤叉
祆	礻天
祎	礻韦
祉	礻止
祇	礻氏
诛	讠朱
诜	讠⺧儿
诟	讠丿丿一口
诠	讠人王
诣	讠匕日
诤	讠⺈乛一一丨
诧	讠宀丿七
诨	讠冖车
诩	讠习习
戕	爿戈
孢	子勹巳
亟	了口又一
陔	阝亠乛丿人
妲	女日一
妯	女由
姗	女册
帑	女又巾
弩	女又弓
孥	女又子
驽	女又马
虱	乛丿虫
迦	辶力口
迨	辶厶口
绀	纟甘
绁	纟世
绂	纟𠂇又丶
驷	马囗儿
驸	马亻寸
绉	纟⺈彐
绌	纟出
驿	马又一一丨
骀	马厶口
甾	乛乛乛田
珏	王玉
珐	王土厶
珂	王丁口
珑	王龙
玳	王亻弋
珀	王白
顸	干一丿冂人
珉	王民
珈	王力口
拮	扌士口
垭	土亚
挝	扌寸辶
垣	土一日一
挞	扌大辶
垤	土一厶土
赳	土丨一人乛丨
贲	十艹冂人
垱	土⺌彐
垌	土冂一口
郝	土丿丨丿丶阝
垧	土丿冂口
垓	土亠乛丿人
挦	扌彐寸
垠	土艮
茜	艹西
荚	艹夹
荑	艹夷
贳	世冂人
荜	艹比左匕十
莒	艹口口
茼	艹冂一口
茴	艹囗口
茱	艹朱
莛	艹壬廴
荞	艹夭丿丨
茯	艹亻犬
荏	艹亻壬
荇	艹彳亍
荃	艹人王
荟	艹人二厶
荀	艹勹日
茗	艹夕口
荠	艹文丿丨
茭	艹亠八乂
茨	艹冫⺈人
垩	亚土
荥	艹冖水
荦	艹冖牛
荨	艹彐寸
荩	艹尺丶丶
剋	十口儿刂
荪	艹子小
茹	艹女口
荬	艹乛丶丶大
荮	艹纟寸
柰	木二小
栉	木艹卩
柯	木丁口
柘	木石
栊	木龙
柩	木匚久
枰	木平
栌	木丨一尸
柙	木甲
枵	木口一乛
柚	木由
枳	木口八
柞	木乍
柝	木斥
栀	木丿丿一乛乛
柢	木氐
栎	木乐
枸	木勹口
柈	木半
柁	木宀匕
枷	木力口
柽	木又土
剌	束刂
酊	酉丁
郦	丽阝
甭	不用
砗	石车
砘	石屯
砒	石比左匕
斫	石斤
砭	石乏
砜	石几乂
奎	大土土
耷	大耳
虺	兀虫
殂	歹且
殇	歹丿一乛丿丿
殄	歹人丿丿丿
殆	歹厶口
轱	车十口
轲	车丁口
轳	车丨一尸
轶	车失
轸	车人丿丿丿
虿	万虫
毖	比左匕必
觇	丨一口冂见下
尜	小大小
哐	口匚王
眄	目丏
眍	目匚乂
𠳐	口寿上阝
郢	口王阝
眇	目少
眊	目毛
眈	目丶乛丿乛
禺	丨乛一一丨乛丨一丶
哂	口西
咴	口𠂇火
曷	日勹人乛
昴	日丿乛丿卩
昱	日立
昵	日尸匕
咦	口夷
哓	口一乛丿兀
哔	口比左匕十
畎	田犬
毗	田比左匕
呲	口止匕
胄	由月
畋	田攵
畈	田丿丿又
虼	虫乞
虻	虫亡
盅	中皿
咣	口⺌兀
哕	口山夕
剐	口内刂
郧	口冂人阝
咻	口亻木
囿	囗𠂇月
咿	口亻尹
哌	口丿丿丿乛丿ㄟ
哙	口人二厶
哚	口几木
咯	口夂口
咩	口羊
咤	口宀丿七
哝	口农
哏	口艮
哞	口厶牛
峙	山土寸
峣	山一乛丿兀
罘	罒不
帧	巾丨一冂人
峒	山冂一口
峤	山夭丿丨
峋	山勹日
峥	山⺈乛一一丨
贶	冂人口儿
钚	钅不
钛	钅太
钡	钅冂人
钣	钅丿丿又
钤	钅人丶乛
钨	钅乌
钫	钅方
钯	钅巴
氡	气夂丶丶
氟	气弗
牯	牛十口
郜	⺧口阝
秕	禾比左匕
秭	禾丿乛丨丿
竽	⺮于
笈	⺮及
笃	⺮马
俦	亻寿上寸
俨	亻严
俅	亻求
俪	亻丽
叟	丿丨一乛一一丨又
垡	亻戈土
牮	亻弋牛
俣	亻口天
俚	亻里
皈	白丿丿又
俑	亻龴用
俟	亻厶矢
逅	辶丿丿一口
徇	彳勹日
徉	彳羊
舢	舟山
俞	人一月刂
郗	乂𠂇巾阝
俎	人人且
郤	八人口阝
爰	丿⺍一𠂇又
郛	丿⺍子阝
瓴	人丶龴瓦
胨	月东
胪	月丨一尸
胛	月甲
胂	月申
胙	月乍
胍	月瓜
胗	月人丿丿丿
胝	月氐
朐	月勹口
胫	月乛丶工
鸨	匕十鸟
匍	勹甫
狨	犭戈𠂇
狯	犭人二厶
飑	几乂勹巳
狩	犭宀寸
狲	犭子小
訇	勹亠一一口
逄	辶夂一乛丨
昝	夂卜日
饷	饣丿冂口
饸	饣人一口
饹	饣夂口
胤	丿幺月乛
孪	亠丨丨丿丶子
娈	亠丨丨丿丶女
弈	亠丿丨丿丶廾
奕	亠丿丨丿丶大
庥	广亻木
疬	疒厂力
疣	疒尤
疥	疒人丿丨
疭	疒人人
庠	广羊
竑	立𠂇厶
彦	产丿丿丿
飒	立几乂
闼	门大辶
闾	门口口
闿	门山己
阂	门亠乛丿人
羑	⺷久
迸	辶丷开
籼	米山
酋	丷酉
炳	火丙
炻	火石
炽	火口八
炯	火冂口
烀	火乎
炷	火主
烃	火乛丶工
洱	氵耳
洹	氵一日一
洧	氵𠂇月
洌	氵歹刂
浃	氵夹
洇	氵囗大
洄	氵囗口
洙	氵朱
涎	氵丿丨一乛廴
洎	氵自
洫	氵血
浍	氵人二厶
洮	氵儿冫丿丶
洵	氵勹日
浒	氵讠午
浔	氵彐寸
浕	氵尺丶丶
洳	氵女口
恸	忄二厶力
恓	忄西
恹	忄厂犬
恫	忄冂一口
恺	忄山己
恻	忄冂人刂
恂	忄勹日
恪	忄夂口
恽	忄冖车
宥	宀𠂇月
扃	户冂口
衲	衤内
衽	衤壬
衿	衤人丶乛
袂	衤夬guài
祛	礻土厶
祜	礻十口
祓	礻𠂇又丶
祚	礻乍
诮	讠⺌月
祗	礻氐
祢	礻⺈小
诰	讠⺧口
诳	讠犭王
鸩	丶乛丿乛鸟
昶	永日
郡	尹口阝
咫	尺口八
弭	弓耳
牁	爿丁口
胥	乛丨一人月
陛	阝比左匕土
陟	阝止丨丿丿
娅	女亚
姮	女一日一
娆	女一乛丿兀
姝	女朱
姣	女亠八乂
姘	女丷开
姹	女宀丿七
怼	又寸心
羿	习习廾
炱	厶口火
矜	龴乛丨丿人丶乛
绔	纟大亏
骁	马一乛丿兀
骅	马亻匕十
绗	纟彳亍
绛	纟夂一乛丨
骈	马丷开
耖	耒少
挈	丰刀手
珥	王耳
珙	王艹一八
顼	王一丿冂人
珰	王⺌彐
珩	王彳亍
珧	王儿冫丿丶
珣	王勹日
珞	王夂口
琤	王⺈乛一一丨
珲	王冖车
敖	龶乛丿攵
恚	土土心
埔	土甫
埕	土口王
埘	土日寸
埙	土口冂人
埚	土口内
挹	扌口巴
耆	耂匕日
耄	耂匕毛
埒	土丿⺍寸
捋	扌丿⺍寸
贽	扌丸冂人
垸	土宀二儿
捃	扌尹口
盍	土厶皿
荸	艹十冖子
莆	艹甫
莳	艹日寸
莴	艹口内
莪	艹我
莠	艹禾乃
莓	艹丿一母
莜	艹亻丨攵
莅	艹亻立
荼	艹人余下
莩	艹丿⺍子
荽	艹丿⺍女
莸	艹犭尤
荻	艹犭火
莘	艹立十
莎	艹氵少
莞	艹宀二儿
莨	艹良
鸪	十口鸟
莼	艹纟屯
栲	木耂一乛
栳	木耂匕
郴	木木阝
桓	木一日一
桡	木一乛丿兀
桎	木一厶土
桢	木丨一冂人
桤	木山己
梃	木壬廴
栝	木千口
桕	木臼
桁	木彳亍
桧	木人二厶
桅	木⺈厂乛乛
栟	木丷开
桉	木宀女
栩	木习习
逑	辶求
逋	辶甫
彧	一口一乛丿丿丿丶
鬲	一口冂丷一丨
豇	一口丷一工
酐	酉干
逦	辶丽
厝	厂艹一日
孬	不女子
砝	石土厶
砹	石艹乂
砺	石厂万
砧	石丨一口
砷	石申
砟	石乍
砼	石人工
砥	石氐
砣	石宀匕
剞	大丁口刂
砻	龙石
轼	车弋工
轾	车一厶土
辂	车夂口
鸫	东鸟
趸	万口丨一人
龀	止人凵匕
鸬	丨一尸鸟
虔	虍文
逍	辶⺌月
眬	目龙
唛	口龶夂
晟	日成
眩	目亠幺
眙	目厶口
哧	口土丿丨丿丶
哽	口更
唔	口五口
晁	日儿冫丿丶
晏	日宀女
鸮	口一乛鸟
趵	⻊勺
趿	⻊及
畛	田人丿丿丿
蚨	虫夫
蚜	虫牙
蚍	虫比左匕
蚋	虫内
蚬	虫冂见下
蚝	虫毛
蚧	虫人丿丨
唢	口⺌冂人
圄	囗五口
唣	口白七
唏	口乂𠂇巾
盎	央皿
唑	口人人土
崂	山艹冖力
崃	山来
罡	罒正
罟	罒十口
峪	山八人口
觊	山己冂见下
赅	冂人亠乛丿人
钰	钅玉
钲	钅正
钴	钅十口
钵	钅本
钹	钅𠂇又丶
钺	钅戈乛
钽	钅日一
钼	钅目
钿	钅田
铀	钅由
铂	钅白
铄	钅乐
铆	钅丿乛丿卩
铈	钅亠巾
铉	钅亠幺
铊	钅宀匕
铋	钅必
铌	钅尸匕
铍	钅乛丿丨又
䥽	钅乛丿又丶
铎	钅又一一丨
氩	气亚
氤	气囗大
氦	气亠乛丿人
毪	毛厶牛
舐	千口氏
秣	禾末
秫	禾术
盉	禾皿
笄	⺮开
笕	⺮冂见下
笊	⺮爪
笏	⺮勿
笆	⺮巴
俸	亻寿上ㄟ一一丨
倩	亻龶月
俵	亻龶𧘇
偌	亻艹𠂇口
俳	亻非
俶	亻上小又
倬	亻丨一日十
倏	亻丨夂犬
恁	亻壬心
倭	亻禾女
倪	亻臼儿
俾	亻丿丨乛一一丿十
倜	亻冂土口
隼	亻亠龶十
隽	亻亠龶乃
倌	亻宀㠯
倥	亻宀八工
臬	自木
皋	白大十
郫	丿丨乛一一丿十阝
倨	亻尸十口
衄	血丑
颀	斤一丿冂人
徕	彳来
舫	舟方
釜	八乂干丶丿一
奚	丿⺍幺大
衾	人丶乛亠𧘇
胯	月大亏
胱	月⺌兀
胴	月冂一口
胭	月囗大
脍	月人二厶
胼	月丷开
朕	月丷天
脒	月米
胺	月宀女
鸱	氐鸟
玺	⺈小玉
鸲	勹口鸟
狷	犭口月
猁	犭禾刂
狳	犭人余下
猃	犭人一⺍一
狺	犭亠一一口
逖	辶犭火
桀	夕一乛丨木
袅	丿乛丶乛亠𧘇
饽	饣十冖子
凇	冫木八厶
栾	亠丨丨丿丶木
挛	亠丨丨丿丶手
亳	亠口冖丿七
疳	疒甘
疴	疒丁口
疸	疒日一
疽	疒且
痈	疒用
疱	疒勹巳
痂	疒力口
痉	疒乛丶工
衮	亠八厶𧘇
凋	冫冂土口
颃	亠几一丿冂人
恣	冫⺈人心
旆	方丿一一丨乛丨
旄	方丿一毛
旃	方丿一丹
阃	门囗木
阄	门⺈丨乛一一乛
訚	门亠一一口
阆	门良
恙	⺷心
粑	米巴
朔	丷一乛丨丿月
郸	丷丨乛一一一丨阝
烜	火一日一
烨	火亻匕十
烩	火人二厶
烊	火羊
剡	火火刂
郯	火火阝
烬	火尺丶丶
涑	氵束
浯	氵五口
涞	氵来
涟	氵车辶
娑	氵少女
涅	氵日土
涠	氵囗韦
浞	氵口丨一人
涓	氵口月
浥	氵口巴
涔	氵山人丶乛
浜	氵丘八
浠	氵乂𠂇巾
浣	氵宀二儿
浚	氵厶八夂
悚	忄束
悭	忄丨丨又土
悝	忄里
悒	忄口巴
悌	忄丷乛一乛丨丿
悛	忄厶八夂
宸	宀厂二乛丿ㄟ
窈	宀八幺力
剜	宀夕乛乛刂
诹	讠耳又
冢	冖一丿乛丿丿丶丿ㄟ
诼	讠一丿乛丿丿丶丿ㄟ
袒	衤日一
袢	衤半
祯	礻丨一冂人
诿	讠禾女
谀	讠臾
谂	讠人丶乛心
谄	讠⺈臼
谇	讠亠人人十
屐	尸彳十又
屙	尸阝丁口
陬	阝耳又
勐	子皿力
奘	爿士大
牂	爿羊
蚩	乛丨丨一虫
陲	阝垂
姬	女匚丨口丨
娠	女厂二乛丿ㄟ
娌	女里
娉	女由一乛
娲	女口内
娩	女⺈丨乛一丿乛
娴	女门木
娣	女丷乛一乛丨丿
娓	女尸毛
婀	女阝丁口
畚	厶大田
逡	辶厶八夂
绠	纟更
骊	马丽
绡	纟⺌月
骋	马由一乛
绥	纟丿⺍女
绦	纟夂朩
绨	纟丷乛一乛丨丿
骎	马亻彐冖又
邕	乛乛乛口巴
鸶	丝鸟
彗	丰丰彐
耜	耒㠯
焘	寿上寸灬
舂	寿上ㄟ臼
琏	王车辶
琇	王禾乃
麸	龶夂夫
揶	扌耳阝
埴	土十具上
埯	土大电
捯	扌一厶土刂
掳	扌虍力
掴	扌囗玉
埸	土日勿
埵	土垂
赧	土丿丨丿丶卩又
埤	土丿丨乛一一丿十
捭	扌丿丨乛一一丿十
逵	辶土八土
埝	土人丶乛心
堋	土月月
堍	土⺈丨乛一丿乛丶
掬	扌勹米
鸷	扌丸鸟
掖	扌亠亻丿乛丶ㄟ
捽	扌亠人人十
掊	扌立口
堉	土亠厶月
掸	扌丷丨乛一一一丨
捩	扌户犬
掮	扌户月
悫	士冖几心
埭	土乛一一丨冫丿ㄟ
埽	土彐冖巾
掇	扌又又又又
掼	扌毌冂人
聃	耳冉
菁	艹龶月
萁	艹其上八
菘	艹木八厶
堇	廿丨乛一一一丨一
萘	艹大二小
萋	艹一乛一一丨女
菽	艹上小又
菖	艹日日
萜	艹巾丨一口
萸	艹臾
萑	艹亻亠龶
棻	艹八刀木
菔	艹月卩又
菟	艹⺈丨乛一丿乛丶
萏	艹⺈臼
萃	艹亠人人十
菏	艹氵丁口
菹	艹氵且
菪	艹宀石
菅	艹宀㠯
菀	艹宀夕乛乛
萦	艹冖幺小
菰	艹子瓜
菡	艹了冫丿丶凵
梵	木木凡
梿	木车辶
梏	木⺧口
觋	工人人冂见下
桴	木丿⺍子
桷	木⺈用
梓	木立十
棁	木丷口儿
桫	木氵少
棂	木彐火
啬	十丶丿一囗口
郾	匚日女阝
匮	匚中一冂人
敕	束攵
豉	一口丷一十又
鄄	西土阝
酞	酉太
酚	酉八刀
戛	一自戈
硎	石开刂
硭	石艹亡
硒	石西
硖	石夹
硗	石一乛丿兀
硐	石冂一口
硇	石丿囗乂
硌	石夂口
鸸	而鸟
瓠	大亏瓜
匏	大亏勹巳
厩	厂即左一乛丿乛
龚	龙艹一八
殒	歹口冂人
殓	歹人一⺍一
殍	歹丿⺍子
赉	来冂人
雩	雨亏
辄	车耳乛
堑	车斤土
眭	目土土
眦	目止匕
啧	口龶冂人
晡	日甫
晤	日五口
眺	目儿冫丿丶
眵	目夕夕
眸	目厶牛
圊	囗龶月
喏	口艹𠂇口
喵	口艹田
啉	口木木
勖	冂一一目力
晞	日乂𠂇巾
唵	口大电
晗	日人丶乛口
冕	冂一一⺈丨乛一丿乛
啭	口车专
畦	田土土
趺	⻊夫
啮	口止人凵
跄	⻊人乛乛
蚶	虫甘
蛄	虫十口
蛎	虫厂万
蛆	虫且
蚰	虫由
蛊	虫皿
圉	囗土丷干
蚱	虫乍
蛉	虫人丶龴
蛏	虫又土
蚴	虫幺力
啁	口冂土口
啕	口勹缶
唿	口勿心
啐	口亠人人十
唼	口立女
唷	口亠厶月
啖	口火火
啵	口氵乛丿丨又
啶	口宀一丨一人
啷	口丶即左阝
唳	口户犬
唰	口尸巾刂
啜	口又又又又
帻	巾龶冂人
崚	山土八夂
崦	山大电
帼	巾囗玉
崮	山囗十口
崤	山乂𠂇月
崆	山宀八工
赇	冂人求
赈	冂人厂二乛丿ㄟ
赊	冂人人二小
铑	钅耂匕
铒	钅耳
铗	钅夹
铙	钅一乛丿兀
铟	钅囗大
铠	钅山己
铡	钅冂人刂
铢	钅朱
铣	钅⺧儿
铤	钅壬廴
铧	钅亻匕十
铨	钅人王
铩	钅乂朩
铪	钅人一口
铫	钅儿冫丿丶
铬	钅夂口
铮	钅⺈乛一一丨
铯	钅⺈巴
铰	钅亠八乂
铱	钅亠𧘇
铳	钅亠厶儿
铵	钅宀女
铷	钅女口
氪	气十口儿
牾	牛五口
鸹	千口鸟
秾	禾农
逶	辶禾女
笺	⺮戋
筇	⺮工阝
笸	⺮匚口
笪	⺮日一
笮	⺮乍
笠	⺮立
笥	⺮乛一口
笤	⺮刀口
笳	⺮力口
笾	⺮力辶
笞	⺮厶口
偾	亻十艹冂人
偃	亻匚日女
偕	亻比左匕白
偈	亻日勹人乛
傀	亻鬼
偬	亻匆心
偻	亻米女
皑	白山己
皎	白亠八乂
鸻	彳亍鸟
徜	彳⺌冂口
舸	舟丁口
舻	舟丨一尸
舴	舟乍
舷	舟亠幺
龛	人一口龙
翎	人丶龴习习
脬	月丿⺍子
脘	月宀二儿
脲	月尸水
匐	勹一口田
猗	犭大丁口
猡	犭罒夕
猞	犭人干口
猝	犭亠人人十
斛	⺈用丶丶十
猕	犭弓⺈小
馗	九丷一自
馃	饣果
馄	饣日比左匕
鸾	亠丨丨丿丶鸟
孰	亠口子丸
庹	广廿尺
庾	广臾
痔	疒土寸
痍	疒夷
疵	疒止匕
翊	立习习
旌	方丿一生
旎	方丿一尸匕
袤	亠龴乛丨丿𧘇
阇	门耂日
阈	门戈口一
阉	门大电
阊	门日日
阋	门臼儿
阍	门氏日
阏	门方人丶丶
羟	⺶乛丶工
粝	米厂万
粕	米白
敝	丶丿丨乛丨丿丶攵
焐	火五口
烯	火乂𠂇巾
焓	火人丶乛口
烽	火夂丰
焖	火门心
烷	火宀二儿
焗	火尸乛口
渍	氵龶冂人
渚	氵耂日
淇	氵其上八
淅	氵木斤
淞	氵木八厶
渎	氵十乛丶丶大
涿	氵一丿乛丿丿丶丿ㄟ
淖	氵丨一日十
挲	氵少手
淠	氵田一丿丨
涸	氵囗十口
渑	氵口电
淦	氵金
淝	氵月巴
淬	氵亠人人十
涪	氵立口
淙	氵宀二小
涫	氵宀㠯
渌	氵彐氺
淄	氵乛乛乛田
惬	忄匚夹
悻	忄土丷干
悱	忄非
惝	忄⺌冂口
惘	忄冂丷一亡
悸	忄禾子
惆	忄冂土口
惚	忄勿心
惇	忄亠口子
惮	忄丷丨乛一一一丨
窕	宀八儿冫丿丶
谌	讠其上八乛
谏	讠柬
扈	户口巴
皲	冖车乛丿丨又
谑	讠虍一乛一
裆	衤⺌彐
袷	衤人一口
裉	衤艮
谒	讠日勹人乛
谔	讠口口亏
谕	讠人一月刂
谖	讠丿⺍一𠂇又
谗	讠⺈丨乛一丿乛丶丶
谙	讠立日
谛	讠亠丷冖巾
谝	讠户冂艹
逯	辶彐氺
郿	乛丨一丿目阝
隈	阝田一乛丿ㄟ
粜	出米
隍	阝白王
隗	阝鬼
婧	女龶月
婊	女龶𧘇
婕	女一乛一一丨一人
娼	女日日
婢	女丿丨乛一一丿十
婵	女丷丨乛一一一丨
胬	女又内人
袈	力口亠𧘇
翌	习习立
恿	龴用心
欸	厶矢⺈人
绫	纟土八夂
骐	马其上八
绮	纟大丁口
绯	纟非
绱	纟⺌冂口
骒	马果
绲	纟日比左匕
骓	马亻亠龶
绶	纟丿⺍冖又
绺	纟夂卜口
绻	纟龹乛乛
绾	纟宀㠯
骖	马厶大丿丿丿
缁	纟乛乛乛田
耠	耒人一口
琫	王寿上ㄟ一一丨
琵	王王比左匕
琶	王王巴
琪	王其上八
瑛	王艹央
琦	王大丁口
琥	王虍几
琨	王日比左匕
靓	龶月冂见下
琰	王火火
琮	王宀二小
琯	王宀㠯
琬	王宀夕乛乛
琛	王冖八木
琚	王尸十口
辇	夫夫车
鼋	二儿口电
揳	扌丰刀大
堞	土世木
搽	扌艹人朩
揸	扌木日一
揠	扌匚日女
堙	土西土
趄	土丨一人且
揖	扌口耳
颉	士口一丿冂人
塄	土罒方
揿	扌钅⺈人
耋	耂匕一厶土
揄	扌人一月刂
蛩	工凡虫
蛰	扌丸虫
塆	土亠丨丨丿丶弓
摒	扌尸丷开
揆	扌乛丶丿丿ㄟ天
掾	扌乛乛豕
聒	耳千口
葑	艹土土寸
葚	艹其上八乛
靰	革兀
靸	革及
葳	艹戌女
葺	艹口耳
葸	艹田心
萼	艹口口亏
葆	艹亻口木
葩	艹白巴
葶	艹亠口冖丁
蒌	艹米女
萱	艹宀一日一
戟	十日十戈
葭	艹乛一丨一一乛一又
楮	木耂日
棼	木木八刀
椟	木十乛丶丶大
棹	木丨一日十
椤	木罒夕
棰	木垂
赍	十冖人人冂人
椋	木亠口小
椁	木亠口子
椪	木丷亚
棣	木乛一一丨冫丿ㄟ
椐	木尸十口
鹁	十冖子鸟
覃	西日十
酤	酉十口
酢	酉乍
酡	酉宀匕
鹂	丽鸟
厥	厂丷一乛丨丿⺈人
殚	歹丷丨乛一一一丨
殛	歹了口又一
雯	雨文
雱	雨方
辊	车日比左匕
辋	车冂丷一亡
椠	车斤木
辍	车又又又又
辎	车乛乛乛田
斐	非文
睄	目⺌月
睑	目人一⺍一
睇	目丷乛一乛丨丿
睃	目厶八夂
戢	口戈丨丨一一一
喋	口世木
嗒	口艹人一口
喃	口十冂丷干
喱	口厂里
喹	口大土土
晷	日夂卜口
喈	口比左匕白
跖	⻊石
跗	⻊亻寸
跞	⻊乐
跚	⻊册
跎	⻊宀匕
跏	⻊力口
跆	⻊厶口
蛱	虫夹
蛲	虫一乛丿兀
蛭	虫一厶土
蛳	虫丨丿一巾
蛐	虫曲
蛔	虫囗口
蛞	虫千口
蛴	虫文丿丨
蛟	虫亠八乂
蛘	虫羊
喁	口禺
喟	口田月
啾	口禾火
嗖	口丿丨一乛一一丨又
喑	口立日
嗟	口⺶工
喽	口米女
嗞	口丷一幺幺
喀	口宀夂口
喔	口尸一厶土
喙	口乛乛豕
嵘	山艹冖木
嵖	山木日一
崴	山戌女
遄	辶山而
詈	罒亠一一口
嵎	山禺
崽	山田心
嵬	山鬼
嵛	山人一月刂
嵯	山⺶工
嵝	山米女
嵫	山丷一幺幺
幄	巾尸一厶土
嵋	山乛丨一丿目
赕	冂人火火
铻	钅五口
铼	钅来
铿	钅丨丨又土
锃	钅口王
锂	钅里
锆	钅⺧口
锇	钅我
锉	钅人人土
锏	钅门日
锑	钅丷乛一乛丨丿
锒	钅良
锔	钅尸乛口
锕	钅阝丁口
掣	丿一一丨乛丨刂手
矬	矢人人土
氰	气龶月
毳	毛毛毛
毽	毛聿廴
犊	牛十乛丶丶大
犄	牛大丁口
犋	牛具上八
鹄	⺧口鸟
犍	牛聿廴
嵇	禾尤山
黍	禾人氺
稃	禾丿⺍子
稂	禾良
筚	⺮比左匕十
筵	⺮丿丨一乛廴
筌	⺮人王
傣	亻寿上ㄟ氺
傈	亻西木
舄	臼勹灬
牍	片十乛丶丶大
傥	亻⺌冖口儿
傧	亻宀丘八
遑	辶白王
傩	亻又亻亠龶
遁	辶丿丿十目
徨	彳白王
媭	丿丿丿一丿冂人女
畲	人二小田
弑	乂朩弋工
颌	人一口一丿冂人
翕	人一口习习
釉	丿米由
鹆	八人口鸟
舜	丿⺍冖夕一乛丨
貂	豸刀口
腈	月龶月
腌	月大电
腓	月非
腆	月丨乛一丨丨一八
腴	月臾
腑	月广亻寸
腚	月宀一丨一人
腱	月聿廴
鱿	鱼尤
鲀	鱼屯
鲂	鱼方
颍	匕水一丿冂人
猢	犭十口月
猹	犭木日一
猥	犭田一乛丿ㄟ
飓	几乂具上八
觞	⺈用丿一乛丿丿
觚	⺈用瓜
猱	犭龴乛丨丿木
颎	匕火一丿冂人
飧	夕人良
馇	饣木日一
馊	饣丿丨一乛一一丨又
亵	亠扌丸𧘇
脔	亠丨丨丿丶内人
裒	亠臼𧘇
痣	疒士心
痨	疒艹冖力
痦	疒五口
痞	疒不口
痤	疒人人土
痫	疒门木
痧	疒氵少
赓	广乛一一丿ㄟ冂人
竦	立束
瓿	立口瓦
啻	亠丷冖巾口
颏	亠乛丿人一丿冂人
鹇	门木鸟
阑	门柬
阒	门目犬
阕	门乛丶丿丿ㄟ天
粞	米西
遒	辶丷酉
孳	丷一幺幺子
焯	火丨一日十
焜	火日比左匕
焙	火立口
焱	火火火
鹈	丷乛一乛丨丿鸟
湛	氵其上八乛
渫	氵世木
湮	氵西土
湎	氵面
湜	氵日一丨一人
渭	氵田月
湍	氵山而
湫	氵禾火
溲	氵丿丨一乛一一丨又
湟	氵白王
溆	氵人余下又
湲	氵丿⺍一𠂇又
湔	氵丷一月刂
湉	氵忄千口
渥	氵尸一厶土
湄	氵乛丨一丿目
滁	氵阝人余下
愠	忄日皿
惺	忄日生
愦	忄中一冂人
惴	忄山而
愀	忄禾火
愎	忄丿一日夂
愔	忄立日
喾	⺍冖⺧口
寐	宀爿未
谟	讠艹日大
扉	户非
裢	衤车辶
裎	衤口王
裥	衤门日
祾	礻土八夂
祺	礻其上八
谠	讠⺌冖口儿
幂	冖日大巾
谡	讠田八夂
谥	讠丷一八皿
谧	讠必皿
遐	辶乛一丨一一乛一又
孱	尸子子子
弼	弓百弓
巽	巳巳艹一八
骘	阝止丨丿丿马
媪	女日皿
媛	女丿⺍一𠂇又
婷	女亠口冖丁
巯	乛丶工亠厶丿丨乛
翚	习习冖车
皴	厶八夂乛丿丨又
婺	龴乛丨丿攵女
骛	龴乛丨丿攵马
缂	纟革
缃	纟木目
缄	纟戌口
彘	乛乛一矢比左匕
缇	纟日一丨一人
缈	纟目少
缌	纟田心
缑	纟亻乛一矢
缒	纟丿㠯辶
缗	纟民日
飨	乡人良
耢	耒艹冖力
瑚	王十口月
瑁	王冂一一目
瑜	王人一月刂
瑗	王丿⺍一𠂇又
瑄	王宀一日一
瑕	王乛一丨一一乛一又
遨	辶龶乛丿攵
骜	龶乛丿攵马
韫	韦日皿
髡	一丨一二厶丿丿丿兀
塬	土厂白小
鄢	正一乛灬阝
趔	土丨一人歹刂
趑	土丨一人冫⺈人
摅	扌虍心
摁	扌囗大心
蜇	扌斤虫
搋	扌丿丿虍几
搪	扌广乛一一丨口
搐	扌亠幺田
搛	扌丷一乛一一丨丨丿ㄟ
搠	扌丷一乛丨丿月
摈	扌宀丘八
彀	士冖一弓几又
毂	士冖车几又
搦	扌弓冫弓冫
搡	扌又又又木
蓁	艹寿上ㄟ禾
戡	其上八乛戈
蓍	艹耂匕日
鄞	廿丨乛一一一丨一阝
靳	革斤
蓐	艹厂二乛丿ㄟ寸
蓦	艹日大马
鹋	艹田鸟
蒽	艹囗大心
蓓	艹亻立口
蓖	艹丿囗乂比左匕
蓊	艹八厶习习
蒯	艹月月刂
蓟	艹鱼刂
蓑	艹亠丨乛一一𧘇
蒿	艹亠口冂口
蒺	艹疒矢
蓠	艹亠乂凵丨乛乛丶
蒟	艹立勹口
蒡	艹亠丷冖方
蒹	艹丷一乛一一丨丨丿ㄟ
蒴	艹丷一乛丨丿月
蒗	艹氵良
蓥	艹冖金
颐	匚丨口丨一丿冂人
楔	木丰刀大
楠	木十冂丷干
楂	木木日一
楝	木柬
楫	木口耳
楸	木禾火
椴	木丿丨一一一几又
槌	木丿㠯辶
楯	木丿丿十目
皙	木斤白
榈	木门口口
槎	木⺶工
榉	木⺍一八一一丨
楦	木宀一日一
楣	木乛丨一丿目
楹	木乃又皿
椽	木乛乛豕
裘	求亠𧘇
剽	西二小刂
甄	西土瓦
酮	酉冂一口
酰	酉⺧儿
酯	酉匕日
酩	酉夕口
蜃	厂二乛丿ㄟ虫
碛	石龶冂人
碓	石亻亠龶
硼	石月月
碉	石冂土口
碚	石立口
碇	石宀一丨一人
碜	石厶大丿丿丿
鹌	大电鸟
辏	车寿上ㄟ天
龃	止人凵且
龅	止人凵勹巳
訾	止匕亠一一口
粲	丨一夕又米
虞	虍口天
睚	目厂土土
嗪	口寿上ㄟ禾
韪	日一丨一人韦
嗷	口龶乛丿攵
嗉	口龶幺小
睨	目臼儿
睢	目亻亠龶
雎	且亻亠龶
睥	目丿丨乛一一丿十
嘟	口耂日阝
嗑	口土厶皿
嗫	口耳又又
嗬	口艹亻丁口
嗔	口十具上八
嗝	口一口冂丷一丨
戥	日生戈
嗄	口一自夂
煦	日勹口灬
暄	日宀一日一
遢	辶日习习
暌	日乛丶丿丿ㄟ天
跬	⻊土土
跶	⻊大辶
跸	⻊比左匕十
跐	⻊止匕
跣	⻊⺧儿
跹	⻊千辶
跻	⻊文丿丨
蛸	虫⺌月
蜊	虫禾刂
蜍	虫人余下
蜉	虫丿⺍子
蜣	虫羌
畹	田宀夕乛乛
蛹	虫龴用
嗣	口冂艹乛一口
嗯	口囗大心
嗥	口白大十
嗲	口八乂夕夕
嗳	口丿⺍冖𠂇又
嗌	口丷一八皿
嗍	口丷一乛丨丿月
嗨	口氵丿一母
嗐	口宀丰口
嗤	口乛丨丨一虫
嗵	口龴用辶
罨	罒大电
嵊	山千丨一一匕丿ㄟ
嵩	山亠口冂口
嵴	山冫丿丶人月
骰	骨几又
锗	钅耂日
锛	钅大十廾
锜	钅大丁口
锝	钅日一寸
锞	钅果
锟	钅日比左匕
锢	钅囗十口
锨	钅斤⺈人
锩	钅龹乛乛
锭	钅宀一丨一人
锱	钅乛乛乛田
雉	矢亻亠龶
氲	气日皿
犏	牛户冂艹
歃	千臼⺈人
稞	禾果
稗	禾丿丨乛一一丿十
稔	禾人丶乛心
筠	⺮土勹冫
筢	⺮扌巴
筮	⺮工人人
筲	⺮⺌月
筱	⺮亻丨攵
牒	片世木
煲	亻口木火
敫	白方攵
徭	彳丿⺍缶
愆	彳氵亍心
艄	舟⺌月
觎	人一月刂冂见下
毹	人一月刂毛
貊	豸百
貅	豸亻木
貉	豸夂口
颔	人丶乛口一丿冂人
腠	月寿上ㄟ天
腩	月十冂丷干
腼	月面
腭	月口口亏
腧	月人一月刂
塍	月龹土
媵	月龹女
詹	⺈厂八亠一一口
鲅	鱼𠂇又丶
鲆	鱼平
鲇	鱼丨一口
鲈	鱼丨一尸
稣	鱼禾
鲋	鱼亻寸
鲐	鱼厶口
肄	匕矢聿
鹐	⺈臼鸟
飕	几乂丿丨一乛一一丨又
觥	⺈用⺌兀
遛	辶丿乛丶刀田
馐	饣⺶丑
鹑	亠口子鸟
亶	亠囗口日一
瘃	疒一丿乛丿丿丶丿ㄟ
痱	疒非
痼	疒囗十口
痿	疒禾女
瘐	疒臾
瘁	疒亠人人十
瘆	疒厶大丿丿丿
麂	广乛丨丨一比左匕几
裔	亠𧘇冂八口
歆	立日⺈人
旒	方丿一亠厶丿丨乛
雍	亠乡亻亠龶
阖	门土厶皿
阗	门十具上八
阙	门丷一乛丨丿⺈人
羧	⺶厶八夂
豢	龹豕
粳	米更
猷	丷酉犬
煳	火十口月
煜	火日立
煨	火田一乛丿ㄟ
煅	火丿丨一一一几又
煊	火宀一日一
煸	火户冂艹
煺	火艮辶
滟	氵丰⺈巴
溱	氵寿上ㄟ禾
溘	氵土厶皿
漭	氵艹犬廾
滢	氵艹冖玉
溥	氵甫寸
溧	氵西木
溽	氵厂二乛丿ㄟ寸
裟	氵少亠𧘇
溻	氵日习习
溷	氵囗豕
滗	氵⺮毛
滫	氵亻丨夂月
溴	氵自犬
滏	氵八乂干丶丿一
滃	氵八厶习习
滦	氵亠丨丨丿丶木
溏	氵广乛一一丨口
滂	氵亠丷冖方
滓	氵宀立十
溟	氵冖日亠八
滪	氵龴乛丨一丿冂人
愫	忄龶幺小
慑	忄耳又又
慊	忄丷一乛一一丨丨丿ㄟ
鲎	⺍冖鱼
骞	宀一一丨丨一八马
窦	宀八十乛丶丶大
窠	宀八果
窣	宀八亠人人十
裱	衤龶𧘇
褚	衤耂日
裨	衤丿丨乛一一丿十
裾	衤尸十口
裰	衤又又又又
禊	礻丰刀大
谩	讠日罒又
谪	讠亠丷冂十口
媾	女一一丨丨一冉
嫫	女艹日大
媲	女丿囗乂比左匕
嫒	女丿⺍冖𠂇又
嫔	女宀丘八
媸	女乛丨丨一虫
缙	纟亚日
缜	纟十具上八
缛	纟厂二乛丿ㄟ寸
辔	纟车纟口
骝	马丿乛丶刀田
缟	纟亠口冂口
缡	纟亠乂凵丨乛乛丶
缢	纟丷一八皿
缣	纟丷一乛一一丨丨丿ㄟ
骟	马户习习
耥	耒⺌冂口
璈	王龶乛丿攵
瑶	王丿⺍缶
瑭	王广乛一一丨口
獒	龶乛丿攵犬
觏	一一丨丨一冉冂见下
慝	匚艹𠂇口心
嫠	未攵厂女
韬	韦丿⺍臼
叆	二厶丿⺍冖𠂇又
髦	一丨一二厶丿丿丿毛
摽	扌西二小
墁	土日罒又
撂	扌田夂口
摞	扌田幺小
撄	扌冂人冂人女
翥	耂日习习
踅	扌斤口丨一人
摭	扌广廿灬
墉	土广乛一一丨乛一一丨
墒	土亠丷冂八口
榖	士冖一木几又
綦	其上八幺小
蔫	艹正一乛灬
蔷	艹十丶丿一囗口
靺	革末
靼	革日一
鞅	革央
靿	革幺力
甍	艹罒冖瓦
蔸	艹白丿乛乛一儿
蔟	艹方丿一矢
蔺	艹门亻亠龶
戬	亚日戈
蕖	艹氵巨木
蔻	艹宀二儿丨一又
蓿	艹宀亻百
斡	十日十人丶丶十
鹕	十口月鸟
蓼	艹习习人丿丿丿
榛	木寿上ㄟ禾
榧	木匚非
榻	木日习习
榫	木亻亠龶十
榭	木身寸
槔	木白大十
榱	木亠丨乛一一𧘇
槁	木亠口冂口
槟	木宀丘八
槠	木讠耂日
榷	木丶乛丿丨亠龶
僰	一丨乛丨丿ㄟ一丨乛丨丿ㄟ人
酽	酉严
酶	酉丿一母
酹	酉丿⺍寸
厮	厂其上八斤
碡	石龶母
碴	石木日一
碣	石日勹人乛
碲	石亠丷冖巾
磋	石⺶工
臧	戊乛一丿臣
豨	豕乂𠂇巾
殡	歹宀丘八
霆	雨壬廴
霁	雨文丿丨
辕	车土口𧘇
蜚	非虫
裴	非亠𧘇
翡	非习习
龇	止人凵止匕
龈	止人凵艮
睿	丨一冖一八人目
䁖	目米女
睽	目乛丶丿丿ㄟ天
嘞	口革力
嘈	口一丨乛一丨丨一日
嘌	口西二小
嘁	口戊上小
嘎	口一自戈
暧	日丿⺍冖𠂇又
暝	日冖日亠八
踌	⻊寿上寸
踉	⻊良
蜞	虫其上八
蜥	虫木斤
蜮	虫戈口一
蝈	虫囗玉
蜴	虫日勿
蜱	虫丿丨乛一一丿十
蜩	虫冂土口
蜷	虫龹乛乛
蜿	虫宀夕乛乛
螂	虫丶即左阝
蜢	虫子皿
嘘	口虍业
嘡	口⺌冖口土
鹗	口口亏鸟
嘣	口山月月
嘤	口冂人冂人女
嘚	口彳日一寸
嗾	口方丿一矢
嘧	口宀必山
罴	罒土厶灬
罱	罒十冂丷干
幔	巾日罒又
嶂	山立日十
幛	巾立日十
赙	冂人甫寸
罂	冂人冂人缶
骷	骨十口
骶	骨氐
鹘	骨鸟
锲	钅丰刀大
锴	钅比左匕白
锶	钅田心
锷	钅口口亏
锸	钅千臼
锵	钅冫丨夕寸
镁	钅⺷大
镂	钅米女
犒	牛亠口冂口
箐	⺮龶月
箦	⺮龶冂人
箧	⺮匚夹
箍	⺮扌匚巾
箸	⺮耂日
箬	⺮艹𠂇口
箅	⺮田一丿丨
箪	⺮丷丨乛一一一丨
箔	⺮氵白
箜	⺮宀八工
箢	⺮宀夕乛乛
箓	⺮彐氺
毓	丿一母亠厶丿丨乛
僖	亻士口丷一口
儆	亻艹勹口攵
僳	亻西米
僭	亻一乛丿乛一乛丿乛日
劁	亻亠龶灬刂
僮	亻立里
魃	鬼𠂇又丶
魆	鬼戈乛
睾	丿罒土丷干
艋	舟子皿
鄱	丿米田阝
膈	月一口冂丷一丨
膑	月宀丘八
鲑	鱼土土
鲔	鱼𠂇月
鲚	鱼文丿丨
鲛	鱼亠八乂
鲟	鱼彐寸
獐	犭立日十
觫	⺈用束
雒	夂口亻亠龶
夤	夕宀一由八
馑	饣廿丨乛一一一丨一
銮	亠丨丨丿丶金
塾	亠口子丸土
麽	广木木么
瘌	疒束刂
瘊	疒亻乛一矢
瘘	疒米女
瘙	疒叉虫
廖	广习习人丿丿丿
韶	立日刀口
旖	方丿一大丁口
膂	方丿一丿乛丿ㄟ月
阚	门乛耳攵
鄯	羊丷一口阝
鲞	龹鱼
粿	米果
粼	米夕一乛丨乛乛
粽	米宀二小
糁	米厶大丿丿丿
槊	丷一乛丨丿月木
鹚	丷一幺幺鸟
熘	火丿乛丶刀田
熥	火龴用辶
潢	氵艹一由八
漕	氵一丨乛一丨丨一日
滹	氵虍乎
漯	氵田幺小
漶	氵串心
潋	氵人一⺍一攵
潴	氵犭耂日
漪	氵犭大丁口
漉	氵广乛丨丨一比左匕
漳	氵立日十
漩	氵方丿一乛丨一人
澉	氵乛耳攵
潍	氵纟亻亠龶
慵	忄广乛一一丨乛一一丨
搴	宀一一丨丨一八手
窨	宀八立日
寤	宀爿五口
綮	户攵幺小
谮	讠一乛丿乛一乛丿乛日
褡	衤艹人一口
褙	衤丨一一匕月
褓	衤亻口木
褛	衤米女
褊	衤户冂艹
谯	讠亻亠龶灬
谰	讠门柬
谲	讠龴乛丨丿冂八口
暨	即左一乛丿乛日一
屣	尸彳止丨一人
鹛	乛丨一丿目鸟
嫣	女正一乛灬
嫱	女十丶丿一囗口
嫖	女西二小
嫦	女⺌冖口巾
嫚	女日罒又
嫘	女田幺小
嫡	女亠丷冂十口
鼐	乃目乛一丿丨一丨乛
翟	习习亻亠龶
瞀	龴乛丨丿攵目
鹜	龴乛丨丿攵鸟
骠	马西二小
缥	纟西二小
缦	纟日罒又
缧	纟田幺小
缨	纟冂人冂人女
骢	马丿囗夂心
缪	纟习习人丿丿丿
缫	纟乛乛乛果
耦	耒禺
耧	耒米女
瑾	王廿丨乛一一一丨一
璜	王艹一由八
璀	王山亻亠龶
璎	王冂人冂人女
璁	王丿囗夂心
璋	王立日十
璇	王方丿一乛丨一人
奭	大百百
髯	一丨一二厶丿丿丿冉
髫	一丨一二厶丿丿丿刀口
撷	扌士口一丿冂人
撅	扌厂丷一乛丨丿⺈人
赭	土丿丨丿丶耂日
撸	扌鱼日
鋆	土勹冫金
撙	扌丷酉寸
撺	扌宀八串
墀	土尸氺牛
聩	耳中一冂人
觐	廿丨乛一一一丨一冂见下
鞑	革大辶
蕙	艹一丨乛一一丨一丶心
鞒	革夭丿丨
蕈	艹西日十
蕨	艹厂丷一乛丨丿⺈人
蕤	艹豕生
蕞	艹日耳又
蕺	艹口戈丨丨一一一
瞢	艹罒冖目
蕃	艹丿米田
蕲	艹丷丨乛一一一丨斤
赜	匚丨口丨龶冂人
槿	木廿丨乛一一一丨一
樯	木十丶丿一囗口
槭	木戊上小
樗	木雨亏
樘	木⺌冖口土
樊	木乂乂木大
槲	木⺈用丶丶十
醌	酉日比左匕
醅	酉立口
靥	厂犬面
魇	厂犬鬼
餍	厂犬人良
磔	石夕一乛丨木
磙	石亠八厶𧘇
霈	雨氵一丨乛丨
辘	车广乛丨丨一比左匕
龉	止人凵五口
龊	止人凵口丨一人
觑	虍业冂见下
瞌	目土厶皿
瞋	目十具上八
瞑	目冖日亠八
嘭	口士口丷一丿丿丿
噎	口士冖一口丷一
噶	口艹日勹人乛
颙	禺一丿冂人
暹	辶日亻亠龶
噘	口厂丷一乛丨丿⺈人
踔	⻊丨一日十
踝	⻊果
踟	⻊矢口
踒	⻊禾女
踬	⻊丿丿十冂人
踮	⻊广丨一口
踯	⻊丷天阝
踺	⻊聿廴
踞	⻊尸十口
蝽	虫寿上ㄟ日
蝾	虫艹冖木
蝻	虫十冂丷干
蝰	虫大土土
蝮	虫丿一日夂
螋	虫丿丨一乛一一丨又
蝓	虫人一月刂
蝣	虫方丿一子
蝼	虫米女
噗	口业⺶ㄟ
嘬	口日耳又
颚	口口亏一丿冂人
噍	口亻亠龶灬
噢	口丿冂米大
噙	口人亠乂凵丨乛乛丶
噜	口鱼日
噌	口丷囗⺌日
噔	口乛丶丿丿ㄟ一口丷一
颛	山而一丿冂人
幞	巾业⺶ㄟ
幡	巾丿米田
嶙	山米夕一乛丨
嶝	山乛丶丿丿ㄟ一口丷一
骺	骨丿丿一口
骼	骨夂口
骸	骨亠乛丿人
镊	钅耳又又
镉	钅一口冂丷一丨
镌	钅亻亠龶乃
镍	钅自木
镏	钅丿乛丶刀田
镒	钅丷一八皿
镓	钅宀豕
镔	钅宀丘八
稷	禾田八夂
箴	⺮戌口
篑	⺮中一冂人
篁	⺮白王
篌	⺮亻乛一矢
篆	⺮乛乛豕
牖	片户甫
儋	亻⺈厂八亠一一口
徵	彳山一王攵
磐	舟几又石
虢	丿⺍寸虍几
鹞	丿⺍缶鸟
膘	月西二小
滕	月龹氺
鲠	鱼更
鲡	鱼丽
鲢	鱼车辶
鲣	鱼丨丨又土
鲥	鱼日寸
鲧	鱼丿幺小
鲩	鱼宀二儿
獗	犭厂丷一乛丨丿⺈人
獠	犭大丶丿日小
觯	⺈用丷丨乛一一一丨
馓	饣艹一月攵
馔	饣巳巳艹一八
麾	广木木毛
廛	广里八土
瘛	疒丰刀心
瘼	疒艹日大
瘢	疒舟几又
瘠	疒冫丿丶人月
齑	文韭丿丨
羯	⺶日勹人乛
羰	⺶山𠂇火
𥻗	米木日一
遴	辶米夕一乛丨
糌	米夂卜日
糍	米丷一幺幺
糅	米龴乛丨丿木
熜	火丿囗夂心
熵	火亠丷冂八口
熠	火习习白
澍	氵士口丷一寸
澌	氵其上八斤
潸	氵木木月
潦	氵大丶丿日小
潲	氵禾⺌月
鋈	氵夭金
潟	氵臼勹灬
潼	氵立里
潺	氵尸子子子
憬	忄日亠口小
憧	忄立里
寮	宀大丶丿日小
窳	宀八瓜瓜
谳	讠十冂丷干犬
褴	衤丨丨丿一丶皿
褟	衤日习习
褫	衤丿丿虍几
谵	讠⺈厂八亠一一口
熨	尸二小寸火
屦	尸彳米女
嬉	女士口丷一口
勰	力力力田心
戮	习习人丿丿丿戈
蝥	龴乛丨丿攵虫
缬	纟士口一丿冂人
缮	纟羊丷一口
缯	纟丷囗⺌日
骣	马尸子子子
畿	幺幺戈田
耩	耒一一丨丨一冉
耨	耒厂二乛丿ㄟ寸
耪	耒亠丷冖方
璞	王业⺶ㄟ
璟	王日亠口小
靛	龶月宀一丨一人
璠	王丿米田
璘	王米夕一乛丨
聱	龶乛丿攵耳
螯	龶乛丿攵虫
髻	一丨一二厶丿丿丿士口
髭	一丨一二厶丿丿丿止匕
髹	一丨一二厶丿丿丿亻木
擀	扌十日十人干
熹	士口丷一口灬
甏	士口丷一丿丿丿瓦
擞	扌米女攵
縠	士冖一丿幺小几又
磬	士乛丨一丿几又石
颞	耳又又一丿冂人
蕻	艹一丨一二厶艹一八
鞘	革⺌月
颟	艹两一丿冂人
薤	艹歹韭
薨	艹罒冖歹匕
檠	艹勹口攵木
薏	艹立日心
薮	艹米女攵
薜	艹尸口立十
薅	艹女厂二乛丿ㄟ寸
樾	木土丨一人戈乛
橛	木厂丷一乛丨丿⺈人
橇	木毛毛毛
樵	木亻亠龶灬
檎	木人亠乂凵丨乛乛丶
橹	木鱼日
樽	木丷酉寸
樨	木尸氺牛
橼	木纟乛乛豕
墼	车凵几又土
橐	一丨乛一丨冖石木
翮	一口冂丷一丨习习
醛	酉艹人王
醐	酉十口月
醍	酉日一丨一人
醚	酉米辶
磲	石氵巨木
赝	厂亻亻亠龶冂人
飙	犬犬犬几乂
殪	歹士冖一口丷一
霖	雨木木
霏	雨非
霓	雨臼儿
錾	车斤金
辚	车米夕一乛丨
臻	一厶土寿上ㄟ禾
遽	辶虍豕
氅	⺌冂口攵毛
瞟	目西二小
瞠	目⺌冖口土
瞰	目乛耳攵
嚄	口艹亻亠龶又
嚆	口艹亠口冂口
噤	口木木二小
暾	日亠口子攵
蹀	⻊世木
踹	⻊山而
踵	⻊重
踽	⻊禹
蹉	⻊⺶工
蹁	⻊户冂艹
螨	虫艹两
蟒	虫艹犬廾
螈	虫厂白小
螅	虫自心
螭	虫亠乂凵丨乛乛丶
螠	虫丷一八皿
螟	虫冖日亠八
噱	口虍豕
噬	口⺮工人人
噫	口立日心
噻	口宀一一丨丨一八丶丶土
噼	口尸口立十
罹	罒忄亻亠龶
圜	囗罒一口𧘇
䦃	钅艹耂日
镖	钅西二小
镗	钅⺌冖口土
镘	钅日罒又
镚	钅山月月
镛	钅广乛一一丨乛一一丨
镝	钅亠丷冂十口
镞	钅方丿一矢
镠	钅习习人丿丿丿
氇	毛鱼日
氆	毛丷亚日
憩	千口自心
穑	禾十丶丿一囗口
篝	⺮一一丨丨一冉
篥	⺮西木
篦	⺮丿囗乂比左匕
篪	⺮丿丿虍几
篙	⺮亠口冂口
盥	丿丨一一水彐皿
劓	自田一丿丨刂
翱	白大十习习
魉	鬼两
魈	鬼⺌月
徼	彳白方攵
歙	人一口习习⺈人
膳	月羊丷一口
膦	月米夕一乛丨
膙	月弓口虫
鲮	鱼土八夂
鲱	鱼非
鲲	鱼日比左匕
鲳	鱼日日
鲴	鱼囗十口
鲵	鱼臼儿
鲷	鱼冂土口
鲻	鱼乛乛乛田
獴	犭艹冖二丿乛丿丿丿ㄟ
獭	犭束⺈冂人
獬	犭⺈用刀牛
邂	辶⺈用刀牛
鹧	广廿灬鸟
廨	广⺈用刀牛
赟	文一弋止冂人
瘰	疒田幺小
廪	广亠囗口二小
瘿	疒冂人冂人女
瘵	疒丿乛丶丶二小
瘴	疒立日十
癃	疒阝夂一生
瘳	疒习习人丿丿丿
斓	文门柬
麇	广乛丨丨一比左匕禾
麈	广乛丨丨一比左匕主
嬴	亡口月女凡
壅	亠乡亻亠龶土
羲	⺷丿一丨丿丶一乛乛丿丶
糗	米自犬
瞥	丶丿丨乛丨丿丶攵目
甑	丷囗⺌日瓦
燎	火大丶丿日小
燠	火丿冂米大
燔	火丿米田
燧	火丷豕辶
濑	氵束⺈冂人
濉	氵目亻亠龶
潞	氵⻊夂口
澧	氵曲一口丷一
澹	氵⺈厂八亠一一口
澥	氵⺈用刀牛
澶	氵亠囗口日一
濂	氵广丷一乛一一丨丨丿ㄟ
褰	宀一一丨丨一八亠𧘇
寰	宀罒一口𧘇
窸	宀八丿米心
褶	衤习习白
禧	礻士口丷一口
嬖	尸口立十女
犟	弓口虫牛
隰	阝日幺幺灬
嬗	女亠囗口日一
颡	又又又木一丿冂人
缱	纟中一㠯辶
缲	纟口口口木
缳	纟罒一口𧘇
璨	王丨一夕又米
璩	王虍豕
璐	王⻊夂口
璪	王口口口木
螫	土丿丨丿丶攵虫
擤	扌自田一丿丨
壕	土亠口冖豕
觳	士冖一⺈用几又
罄	士乛丨一丿几又缶
擢	扌习习亻亠龶
薹	艹士口冖一厶土
鞡	革扌立
鞬	革聿廴
薷	艹雨而
薰	艹丿一丨乛丶丿一丨一一灬
藓	艹鱼羊
藁	艹亠口冂口木
檄	木白方攵
檩	木亠囗口二小
懋	木龴乛丨丿木心
醢	酉𠂇口皿
翳	匚矢几又习习
礅	石亠口子攵
磴	石乛丶丿丿ㄟ一口丷一
鹩	大丶丿日小鸟
龋	止人凵禹
龌	止人凵尸一厶土
豳	山豕豕
壑	丨一冖一八人口又土
黻	业丶丿丨乛丨丿丶𠂇又丶
嚏	口十冖田乛丨一人
嚅	口雨而
蹑	⻊耳又又
蹒	⻊艹两
蹊	⻊丿⺍幺大
蟥	虫艹一由八
螬	虫一丨乛一丨丨一日
螵	虫西二小
疃	田立里
螳	虫⺌冖口土
蟑	虫立日十
嚓	口宀丿乛丶丶二小
羁	罒革马
罽	罒厂火火刂
罾	罒丷囗⺌日
嶷	山匕矢龴乛丨一人
黜	黑出
黝	黑幺力
髁	骨果
髀	骨丿丨乛一一丿十
镡	钅西日十
镢	钅厂丷一乛丨丿⺈人
镣	钅大丶丿日小
镦	钅亠口子攵
镧	钅门柬
镩	钅宀八串
镪	钅弓口虫
镫	钅乛丶丿丿ㄟ一口丷一
罅	缶虍乎
黏	禾人氺丨一口
簌	⺮束⺈人
篾	⺮罒戍
篼	⺮白丿乛乛一儿
簖	⺮米乛斤
簋	⺮艮皿
鼢	臼乛丶丶乛丶丶乛八刀
黛	亻弋黑
儡	亻田田田
鹪	亻亠龶灬鸟
鼾	自田一丿丨干
皤	白丿米田
魍	鬼冂丷一亡
龠	人一口口口冂艹
繇	丿⺍缶丿幺小
貘	豸艹日大
邈	辶豸白儿
貔	豸丿囗乂比左匕
臌	月士口丷一十又
膻	月亠囗口日一
臆	月立日心
臃	月亠乡亻亠龶
鲼	鱼十艹冂人
鲽	鱼世木
鳀	鱼日一丨一人
鳃	鱼田心
鳅	鱼禾火
鳇	鱼白王
鳊	鱼户冂艹
螽	夂丶丶虫虫
燮	火亠一一口火又
鹫	亠口小尤鸟
襄	亠口口一一丨丨一𧘇
糜	广木木米
縻	广木木幺小
膺	广亻亻亠龶月
癍	疒王文王
麋	广乛丨丨一比左匕米
懑	氵艹两心
濡	氵雨而
濮	氵亻业⺶ㄟ
濞	氵自田一丿丨
濠	氵亠口冖豕
濯	氵习习亻亠龶
蹇	宀一一丨丨一八口丨一人
謇	宀一一丨丨一八亠一一口
邃	辶宀八丷豕
襁	衤弓口虫
檗	尸口立十木
擘	尸口立十手
孺	子雨而
隳	阝𠂇工月人⺗
嬷	女广木木么
蟊	龴乛丨丿虫虫
鹬	龴乛丨丿冂八口鸟
鍪	龴乛丨丿攵金
鏊	龶乛丿攵金
鳌	龶乛丿攵鱼
鬈	一丨一二厶丿丿丿龹乛乛
鬃	一丨一二厶丿丿丿宀二小
瞽	士口丷一十又目
鞯	革艹𠂇丨子
鞨	革日勹人乛
鞫	革勹亠一一口
鞧	革丷酉
鞣	革龴乛丨丿木
藜	艹禾勹丿人氺
藠	艹白白白
藩	艹氵丿米田
醪	酉习习人丿丿丿
蹙	戊上小口丨一人
礓	石一田一田一
燹	豕豕火
餮	歹人丿丿丿人良
瞿	目目亻亠龶
曛	日丿一丨乛丶丿一丨一一灬
颢	日亠口小一丿冂人
曜	日习习亻亠龶
躇	⻊艹耂日
蹚	⻊⺌冖口土
鹭	⻊夂口鸟
蟛	虫士口丷一丿丿丿
蟪	虫一丨乛一一丨一丶心
蟠	虫丿米田
蟮	虫羊丷一口
鹮	罒一口𧘇鸟
黠	黑士口
黟	黑夕夕
髅	骨米女
髂	骨宀夂口
镬	钅艹亻亠龶又
镭	钅雨田
镯	钅罒勹虫
馥	禾日丿一日夂
簟	⺮西日十
簪	⺮一乛丿乛一乛丿乛日
鼬	臼乛丶丶乛丶丶乛由
雠	亻亠龶讠亻亠龶
艟	舟立里
鳎	鱼日习习
鳏	鱼罒丨丿丿丶丶
鳐	鱼丿⺍缶
癞	疒束⺈冂人
癔	疒立日心
癜	疒尸艹一八几又
癖	疒尸口立十
糨	米弓口虫
蹩	丶丿丨乛丨丿丶攵口丨一人
鎏	氵亠厶丿丨乛金
懵	忄艹罒冖目
彝	乛乛一米幺小廾
邋	辶乛乛乛囗乂乛丶丶乛丶丶乛
鬏	一丨一二厶丿丿丿禾火
攉	扌雨亻亠龶
攒	扌⺧儿⺧儿冂人
鞲	革一一丨丨一冉
鞴	革艹一丿用
藿	艹雨亻亠龶
蘧	艹虍豕辶
蘅	艹彳⺈田大亍
麓	木木广乛丨丨一比左匕
醮	酉亻亠龶灬
醯	酉亠厶丿丨乛皿
酃	雨口口口阝
霪	雨氵丿⺍壬
霭	雨讠日勹人乛
霨	雨尸二小寸
黼	业丶丿丨乛丨丿丶甫
嚯	口雨亻亠龶
蹰	⻊厂一口丷一寸
蹶	⻊厂丷一乛丨丿⺈人
蹽	⻊大丶丿日小
蹼	⻊业⺶ㄟ
蹴	⻊亠口小尤
蹾	⻊亠口子攵
蹿	⻊宀八串
蠖	虫艹亻亠龶又
蠓	虫艹冖二丿乛丿丿丿ㄟ
蟾	虫⺈厂八亠一一口
蠊	虫广丷一乛一一丨丨丿ㄟ
黢	黑厶八夂
髋	骨宀艹冂见下
髌	骨宀丘八
镲	钅宀丿乛丶丶二小
籀	⺮扌丿乛丶刀田
籁	⺮束⺈冂人
齁	自田一丿丨勹口
魑	鬼亠乂凵丨乛乛丶
艨	舟艹冖二丿乛丿丿丿ㄟ
鳓	鱼革力
鳔	鱼西二小
鳕	鱼雨彐
鳗	鱼日罒又
鳙	鱼广乛一一丨乛一一丨
麒	广乛丨丨一比左匕其上八
鏖	广乛丨丨一比左匕金
羸	亡口月羊凡
㸆	火⺧口非
瀚	氵十日十人习习
瀣	氵丨一夕又韭
瀛	氵亡口月女凡
襦	衤雨而
谶	讠人人戈韭
襞	尸口立十亠𧘇
骥	马丨一一匕田艹一八
缵	纟⺧儿⺧儿冂人
瓒	王⺧儿⺧儿冂人
攘	扌亠口口一一丨丨一𧘇
蘩	艹丿一母攵幺小
蘖	艹丿㠯立十木
醴	酉曲一口丷一
霰	雨艹一月攵
酆	山丰丰一口丷一阝
矍	目目亻亠龶又
曦	日⺷丿一丨丿丶一乛乛丿丶
躅	⻊罒勹虫
鼍	口口田一口电
巉	山⺈口比左匕⺈丨乛一丿乛丶
黩	黑十乛丶丶大
黥	黑亠口小
黪	黑厶大丿丿丿
镳	钅广乛丨丨一比左匕灬
镴	钅乛乛乛囗乂乛丶丶乛丶丶乛
黧	禾勹丿黑
纂	⺮目大幺小
璺	丿丨一一冂一口乛一一冖玉
鼯	臼乛丶丶乛丶丶乛五口
臜	月⺧儿⺧儿冂人
鳜	鱼厂丷一乛丨丿⺈人
鳝	鱼羊丷一口
鳟	鱼丷酉寸
獾	犭艹口口亻亠龶
孀	女雨木目
骧	马亠口口一一丨丨一𧘇
瓘	王艹口口亻亠龶
鼙	士口丷一十又丿丨乛一一丿十
醺	酉丿一丨乛丶丿一丨一一灬
礴	石艹氵甫寸
颦	止丨丿丿一丿冂人丿丨乛一一丿十
曩	日亠口口一一丨丨一𧘇
鳢	鱼曲一口丷一
癫	疒十具上八一丿冂人
麝	广乛丨丨一比左匕身寸
夔	丷一自止巳八夂
爝	火丿⺍罒即左寸
灏	氵日亠口小一丿冂人
禳	礻亠口口一一丨丨一𧘇
鐾	尸口立十金
羼	尸羊⺶羊
蠡	乛乛豕虫虫
耱	耒广木木石
懿	士冖一口丷一冫⺈人心
蘸	艹酉亻亠龶灬
鹳	艹口口亻亠龶鸟
霾	雨豸里
氍	目目亻亠龶毛
饕	口一乛虍几人良
躐	⻊乛乛乛囗乂乛丶丶乛丶丶乛
髑	骨罒勹虫
镵	钅⺈口比左匕⺈丨乛一丿乛丶
穰	禾亠口口一一丨丨一𧘇
饔	亠乡亻亠龶人良
鬻	弓米弓一口冂丷一丨
鬟	一丨一二厶丿丿丿罒一口𧘇
趱	土丨一人⺧儿⺧儿冂人
攫	扌目目亻亠龶又
攥	扌⺮目大幺小
颧	艹口口亻亠龶一丿冂人
躜	⻊⺧儿⺧儿冂人
鼹	臼乛丶丶乛丶丶乛日宀女
癯	疒目目亻亠龶
麟	广乛丨丨一比左匕米夕一乛丨
蠲	丷一八皿罒勹虫
蠹	一丨乛一丨冖石虫虫
躞	⻊火亠一一口火又
衢	彳目目亻亠龶亍
鑫	金金金
灞	氵雨革月
襻	衤木乂乂木大手
纛	龶母具上小丿幺小
鬣	一丨一二厶丿丿丿乛乛乛囗乂乛丶丶乛丶丶乛
攮	扌一丨乛一丨冖口口一一丨丨一𧘇
囔	口一丨乛一丨冖口口一一丨丨一𧘇
馕	饣一丨乛一丨冖口口一一丨丨一𧘇
戆	立日十夂工冂人心
爨	丿丨一一冂一口乛一一冖木木大火
齉	自田一丿丨一丨乛一丨冖口口一一丨丨一𧘇
亍	二丨
尢	𠂇乛
彳	丿亻
卬	丿乛卩
殳	几又
𠙶	了凵
毌	乛乛丨一
邘	于阝
戋	一一乛丿丶
圢	土丁
氕	气丿
伋	亻及
仝	人工
冮	冫工
氿	氵九
汈	氵刁
氾	氵乛乛
忉	忄刀
宄	宀九
𬣙	讠于
讱	讠刃
扞	扌干
圲	土千
圫	土丿七
芏	艹土
芃	艹凡
朳	木八
朸	木力
𨙸	十又阝
邨	屯阝
吒	口丿七
吖	口丫
屼	山兀
屾	山山
辿	辶山
钆	钅乛
仳	亻比左匕
伣	亻冂见下
伈	亻心
癿	白乛
甪	丿用
邠	八刀阝
犴	犭干
冱	冫互
邡	方阝
闫	门三
𬇕	氵万
汋	氵勺
䜣	讠斤
讻	讠乂凵
𬣞	讠宀一
孖	子子
𬘓	纟川
纩	纟广
玒	王工
玓	王勺
玘	王己
玚	王乛丿丿
刬	戋刂
𫭟	土匚乂
坜	土厂力
坉	土屯
扽	扌屯
𫭢	土人匕
坋	土八刀
扺	扌氏
㧑	扌为
毐	士毋
芰	艹十又
芣	艹不
苊	艹厂乛乛
苉	艹匚儿
芘	艹比左匕
芴	艹勿
芠	艹文
𫇭	艹为
芤	艹乛
杕	木大
杙	木弋
杄	木千
杧	木亡
杩	木马
尪	尢王
尨	𠂇乛丿丿丿丶
轪	车大
𫐄	车兀
坒	比左匕土
芈	丨一丨一一一丨
旴	日于
旵	日山
呙	口内
㕮	口八乂
岍	山开
𫵷	山厂力
岠	山巨
岜	山巴
呇	水口
冏	冂八口
觃	冂见下子
岙	夭山
伾	亻丕
㑇	亻⺈彐
伭	亻亠幺
佖	亻必
伲	亻尸匕
佁	亻厶口
飏	几乂乛丿丿
狃	犭丑
闶	门亠几
汧	氵开
汫	氵井
𣲘	氵无
𣲗	氵韦
沄	氵二厶
沘	氵比左匕
𬇙	氵冂人
汭	氵内
㳇	氵八乂
沇	氵厶儿
忮	忄十又
忳	忄屯
忺	忄⺈人
𬣡	讠戋
祃	礻马
诇	讠冂口
邲	必阝
诎	讠出
诐	讠乛丿丨又
屃	尸冂人
𫸩	弓匚乂
岊	巴山
阽	阝丨一口
䢺	出阝
阼	阝乍
妧	女二儿
妘	女二厶
𨚕	厶廾阝
纮	纟𠂇厶
驲	马日
𫘜	马文
纻	纟宀一
𬘘	纟丶乛丿乛
𫘝	马夬guài
纼	纟弓丨
玤	王丰
玞	王夫
玱	王人乛乛
玟	王文
邽	土土阝
邿	土寸阝
坥	土且
坰	土冂口
坬	土瓜
坽	土人丶龴
弆	土厶廾
耵	耳丁
䢼	艹一八阝
𦭜	艹口八
茋	艹氐
苧	艹宀丁
苾	艹必
苠	艹民
枅	木开
㭎	木冂乂
枘	木内
枍	木八一乛
矼	石工
矻	石乞
匼	匚人一口
𬨂	车氏
𬀩	日韦
𬀪	日冂见下
旿	日午
昇	日升
昄	日丿丿又
昒	日勿
昈	日户
咉	口央
咇	口必
咍	口厶口
岵	山十口
岽	山东
岨	山且
岞	山乍
峂	山夂丶丶
㟃	山乛一口
囷	囗禾
𬬩	钅弋
钐	钅丿丿丿
钔	钅门
钖	钅乛丿丿
牥	牛方
佴	亻耳
垈	亻弋土
侁	亻⺧儿
侹	亻壬廴
佸	亻千口
佺	亻人王
隹	亻亠龶
㑊	亻亠丿丨丿丶
侂	亻广丿七
佽	亻冫⺈人
侘	亻宀丿七
郈	丿丿一口阝
舠	舟刀
郐	人二厶阝
郃	人一口阝
攽	八刀攵
肭	月内
肸	月八十
肷	月⺈人
狉	犭丕
狝	犭⺈小
饳	饣出
忞	文心
於	方人丶丶
炌	火人丿丨
炆	火文
泙	氵平
沺	氵田
泂	氵冂口
泜	氵氐
泃	氵勹口
泇	氵力口
怊	忄刀口
峃	⺍冖山
穸	宀八夕
祋	礻几又
祊	礻方
𫍣	讠冂一口
𬣳	讠艮
𬩽	彐寸阝
鸤	尸鸟
弢	弓乛丨丨又
弨	弓刀口
陑	阝而
𬮿	阝山己
陎	阝朱
𬯀	阝文丿丨
卺	了乛丿ㄟ一乛乛
乸	也母
妭	女𠂇又丶
姈	女人丶龴
𫰛	女乛丶工
迳	辶乛丶工
叕	又又又又
𬳵	马丕
驵	马且
𬳶	马冂口
䌹	纟冂口
驺	马⺈彐
𫠊	马亠幺
绋	纟弗
绐	纟厶口
砉	丰石
耔	耒子
㛃	丰刀女
玶	王平
珇	王且
珅	王申
𬍛	王乐
珋	王丿乛丿卩
玹	王亠幺
珌	王必
玿	王刀口
韨	韦𠂇又丶
垚	土土土
垯	土大辶
垙	土⺌兀
垲	土山己
埏	土丿丨一乛廴
垍	土自
耇	耂勹口
鿍	土夂一乛丨
垎	土夂口
垴	土亠乂凵
垟	土羊
垞	土宀丿七
挓	扌宀丿七
垵	土宀女
垏	土聿
拶	扌乛乛乛夕
荖	艹耂匕
荁	艹一日一
荙	艹大辶
荛	艹一乛丿兀
茈	艹止匕
茽	艹亻中
荄	艹亠乛丿人
茺	艹亠厶儿
𬜬	艹门口
荓	艹丷开
茳	艹氵工
𦰡	艹乛一一丿阝
茛	艹艮
荭	艹纟工
㭕	木土厶
柷	木口儿
柃	木人丶龴
柊	木夂丶丶
枹	木勹巳
栐	木永
柖	木刀口
郚	五口阝
剅	一口丷一刂
䴓	一巾鸟
迺	辶西
厖	厂𠂇乛丿丿丿丶
砆	石夫
砑	石牙
砄	石夬guài
耏	而丿丿丿
奓	大夕夕
䶮	龙天
轵	车口八
轷	车乎
轹	车乐
轺	车刀口
昺	日丙
𪾢	目冂见下
昽	日龙
盷	目勹冫
咡	口耳
咺	口一日一
昳	日失
昣	日人丿丿丿
哒	口大辶
昤	日人丶龴
昫	日勹口
昡	日亠幺
咥	口一厶土
昪	日厶廾
虷	虫干
虸	虫子
哃	口冂一口
峘	山一日一
耑	山而
峛	山歹刂
𪨰	山曲
峗	山⺈厂乛乛
峧	山亠八乂
帡	巾丷开
钘	钅开
𫓧	钅夫
钜	钅巨
𬬮	钅长
𬬱	钅斤
𬬭	钅人匕
钪	钅亠几
钬	钅火
钭	钅丶丶十
矧	矢弓丨
秬	禾巨
俫	亻来
舁	臼廾
俜	亻由一乛
俙	亻乂𠂇巾
俍	亻良
垕	丿丿一口土
衎	彳干亍
舣	舟义
弇	人一口廾
侴	人一丑刂
鸧	人乛乛鸟
䏡	月二小
胠	月土厶
𦙶	月十口
胈	月𠂇又丶
胩	月上卜
胣	月丿一也
朏	月出
飐	几乂丨一口
訄	九亠一一口
饻	饣亠𧘇
庤	广土寸
疢	疒火
炣	火丁口
炟	火日一
㶲	火用
洭	氵匚王
洘	氵耂一乛
洓	氵一丨乛丨丿ㄟ
洿	氵大亏
㳚	氵戍
泚	氵止匕
浈	氵丨一冂人
浉	氵丨丿一巾
洸	氵⺌兀
洑	氵亻犬
洢	氵亻尹
洈	氵⺈厂乛乛
洚	氵夂一乛丨
洺	氵夕口
洨	氵亠八乂
浐	氵产
㳘	氵亠厶儿
洴	氵丷开
洣	氵米
恔	忄亠八乂
宬	宀成
窀	宀八屯
扂	户丨一口
袆	衤韦
祏	礻石
祐	礻𠂇口
祕	礻必
叚	乛一丨一一乛一又
陧	阝日土
陞	阝升土
娀	女戈𠂇
姞	女士口
姱	女大亏
姤	女丿丿一口
姶	女人一口
姽	女⺈厂乛乛
枲	厶口木
绖	纟一厶土
骃	马囗大
𬘡	纟囗大
𬳽	马⺧儿
𬘩	纟壬廴
𫄧	纟丿丨一乛廴
彖	乛乛豕
骉	马马马
恝	丰刀心
珪	王土土
珛	王𠂇月
珹	王成
琊	王牙阝
玼	王止匕
珖	王⺌兀
𪟝	龶冂人力
珽	王壬廴
珦	王丿冂口
珫	王亠厶儿
珒	王聿
𬍤	王彐寸
珢	王艮
珕	王力力力
珝	王习习
𫭼	土艹冖力
埗	土止丨丿丿
垾	土日干
垺	土丿⺍子
埆	土⺈用
垿	土广龴乛丨
埌	土良
埇	土龴用
莰	艹土⺈人
茝	艹匚丨口丨
𬜯	艹两
鄀	艹𠂇口阝
莶	艹人一⺍一
莝	艹人人土
䓖	艹宀八力
莙	艹尹口
栻	木弋工
桠	木亚
𬂩	木夹
桄	木⺌兀
梠	木口口
栴	木丿一丹
梴	木丿丨一乛廴
栒	木勹日
酎	酉寸
酏	酉也
𫠆	十又一丿冂人
砵	石本
砠	石且
砫	石主
砬	石立
硁	石乛丶工
恧	而心
翃	𠂇厶习习
郪	一乛一一丨女阝
𨐈	车⺌兀
辀	车舟
辁	车人王
𬌗	牙人一口
剕	非刂
赀	止匕冂人
哢	口王廾
晅	日一日一
晊	日一厶土
唝	口工冂人
哳	口扌斤
哱	口十冖子
冔	冂一一口于
晔	日亻匕十
晐	日亠乛丿人
晖	日冖车
畖	田瓜
蚄	虫方
蚆	虫巴
𫑡	口电阝
帱	巾寿上寸
崁	山土⺈人
峿	山五口
𪨶	山大车
崄	山人一⺍一
帨	巾丷口儿
崀	山良
赆	冂人尺丶丶
𬬸	钅术
钷	钅匚口
𬬻	钅丨一尸
𬬹	钅申
𬬿	钅刀口
𬭁	钅母
眚	生目
甡	生生
笫	⺮丿乛丨丿
倻	亻耳阝
倴	亻大十廾
脩	亻丨夂月
倮	亻果
倕	亻垂
倞	亻亠口小
𫢸	亻丷丨乛一一一丨
倓	亻火火
倧	亻宀二小
衃	血不
虒	丿丿虍几
舭	舟比左匕
舯	舟中
舥	舟巴
瓞	瓜失
鬯	乂丶丶丶丶凵匕
鸰	人丶龴鸟
脎	月乂朩
朓	月儿冫丿丶
胲	月亠乛丿人
虓	九虍几
鱽	鱼刀
狴	犭比左匕土
峱	犭丑山
狻	犭厶八夂
眢	夕乛乛目
𫗧	饣束
勍	亠口小力
痄	疒乍
疰	疒主
痃	疒亠幺
竘	立勹口
羖	⺶几又
羓	⺶巴
桊	龹木
敉	米攵
烠	火𠂇月
烔	火冂一口
烶	火壬廴
烻	火丿丨一乛廴
𬊈	火彐寸
涍	氵耂子
浡	氵十冖子
浭	氵更
浬	氵里
涄	氵由一乛
涢	氵口冂人
涐	氵我
浰	氵禾刂
浟	氵亻丨攵
浛	氵人丶乛口
浼	氵⺈丨乛一丿乛
浲	氵夂丰
涘	氵厶矢
悈	忄戈廾
悃	忄囗木
悢	忄良
𬒈	⺍冖石
宧	宀匚丨口丨
窅	宀八目
窊	宀八瓜
窎	宀八鸟
扅	户夕夕
扆	户亠𧘇
袪	衤土厶
袗	衤人丿丿丿
袯	衤乛丿又丶
祧	礻儿冫丿丶
隺	丶乛丿丨亠龶
堲	即左卩土
疍	乛丨一人日一
𨺙	阝臼儿
陴	阝丿丨乛一一丿十
烝	了乛丿ㄟ一灬
砮	女又石
㛚	女龴用
哿	力口丁口
翀	习习中
翂	习习八刀
剟	又又又又刂
𬳿	马人余下
𫄨	纟乂𠂇巾
绤	纟八人口
骍	马立十
𬘫	纟宀二儿
䂮	丰刀石
琎	王井辶
珸	王五口
珵	王口王
琄	王口月
琈	王丿⺍子
琀	王人丶乛口
珺	王尹口
掭	扌天⺗
堎	土土八夂
堐	土厂土土
埼	土大丁口
掎	扌大丁口
埫	土⺌冂口
堌	土囗十口
晢	扌斤日
𫮃	土丷丨乛一一一丨
掞	扌火火
埪	土宀八工
壸	士冖亚
㙍	土又又又又
聍	耳宀丁
菝	艹扌𠂇又丶
萚	艹扌又一一丨
菥	艹木斤
莿	艹一丨乛丨丿ㄟ刂
䓫	艹大丁口
勚	世冂人力
䓬	艹丨一日十
萆	艹丿丨乛一一丿十
菂	艹白勺
菍	艹人丶乛心
菼	艹火火
萣	艹宀一丨一人
䓨	艹冖缶
菉	艹彐氺
䓛	艹尸出
梼	木寿上寸
梽	木士心
桲	木十冖子
梾	木来
桯	木口王
梣	木山人丶乛
梌	木人余下
桹	木良
敔	五口攵
厣	厂犬甲
硔	石艹一八
鿎	石大辶
硙	石山己
硚	石夭丿丨
硊	石⺈厂乛乛
硍	石艮
勔	面力
䴕	歹刂鸟
龁	止人凵乞
逴	辶丨一日十
唪	口寿上ㄟ一一丨
啫	口耂日
翈	甲习习
㫰	日良
晙	日厶八夂
畤	田土寸
𬱖	由一丿冂人
趼	⻊开
跂	⻊十又
蛃	虫丙
蚲	虫平
𬟽	虫东
蚺	虫冉
啴	口丷丨乛一一一丨
䎃	冉习习
崧	山木八厶
崟	山金
崞	山亠口子
崒	山亠人人十
崌	山尸十口
崡	山了冫丿丶凵
铏	钅开刂
𫓯	钅土土
𫟹	钅艹一八
铕	钅𠂇月
𫟼	钅大辶
铖	钅成
铘	钅牙阝
铚	钅一厶土
铞	钅口巾
铥	钅丿土厶
铴	钅氵乛丿丿
牻	牛𠂇乛丿丿丿丶
牿	牛⺧口
稆	禾口口
笱	⺮勹口
笯	⺮女又
偰	亻丰刀大
偡	亻其上八乛
鸺	亻木鸟
偭	亻面
偲	亻田心
偁	亻丿⺍冉
㿠	白⺌兀
鄅	禹阝
偓	亻尸一厶土
徛	彳大丁口
衒	彳亠幺亍
舳	舟由
舲	舟人丶龴
鸼	舟鸟
悆	人余下心
鄃	人一月刂阝
瓻	乂𠂇巾瓦
䝙	豸匚乂
脶	月口内
脞	月人人土
脟	月丿⺍寸
䏲	月丷乛一乛丨丿
鱾	鱼己
猇	犭虍几
猊	犭臼儿
猄	犭亠口小
觖	⺈用夬guài
𠅤	亠田心
庱	广土八夂
庼	广比左一丿冂人
庳	广丿丨乛一一丿十
痓	疒一厶土
䴔	亠八乂鸟
竫	立⺈乛一一丨
堃	方方土
阌	门丿⺍冖又
羝	⺶氐
羕	⺷永
焆	火口月
烺	火良
焌	火厶八夂
淏	氵日天
𬇹	氵囗玉
淟	氵丨乛一丨丨一八
淜	氵月月
淴	氵勿心
淯	氵亠厶月
湴	氵丷亚
涴	氵宀夕乛乛
𬍡	氵乛丿丿玉
㥄	忄土八夂
惛	忄氏日
惔	忄火火
悰	忄宀二小
惙	忄又又又又
寁	宀一乛一一丨一人
逭	辶宀㠯
𬤇	讠西土
𫍯	讠戌口
袼	衤夂口
裈	衤冖车
祲	礻亻彐冖又
𬤊	讠日一丨一人
𫍲	讠丿丨一乛一一丨又
谞	讠乛丨一人月
艴	弗⺈巴
弸	弓月月
弶	弓亠口小
𬯎	阝中一冂人
隃	阝人一月刂
婞	女土丷干
娵	女耳又
婼	女艹𠂇口
媖	女艹央
婳	女一田凵
婍	女大丁口
婌	女上小又
婫	女日比左匕
婤	女冂土口
婘	女龹乛乛
婠	女宀㠯
𬘬	纟龶月
𬘭	纟木木
𬴂	马非
𫘦	马勹缶
绹	纟勹缶
𫟅	纟亠口小
𬘯	纟亠口子
骕	马肃
𫘧	马彐氺
絜	丰刀幺小
珷	王一弋止
琲	王非
琡	王上小又
琟	王亻亠龶
琔	王宀一丨一人
琭	王彐氺
堾	土寿上ㄟ日
堼	土土寸土
揕	扌其上八乛
㙘	土西女
堧	土而大
喆	士口士口
堨	土日勹人乛
塅	土丿丨一一一几又
堠	土亻乛一矢
絷	扌丸幺小
𪣻	土米女
𡎚	土户冂艹
葜	艹丰刀大
惎	其上八心
萳	艹十冂丷干
葙	艹木目
靬	革干
葴	艹戌口
蒇	艹戊冂人
蒈	艹比左匕白
鄚	艹日大阝
蒉	艹中一冂人
蓇	艹骨
萩	艹禾火
蒐	艹鬼
葰	艹亻厶八夂
葎	艹彳聿
鄑	亚日阝
蒎	艹氵丿丿丿乛丿ㄟ
葖	艹宀八犬
蒄	艹冖二儿寸
萹	艹户冂艹
棤	木艹一日
棽	木木人丶乛
棫	木戈口一
椓	木一丿乛丿丿丶丿ㄟ
椑	木丿丨乛一一丿十
𬃊	木丿丿十冂人
鹀	工人人鸟
椆	木冂土口
棓	木立口
棬	木龹乛乛
棪	木火火
椀	木宀夕乛乛
楗	木聿廴
𬷕	甫鸟
甦	更生
酦	酉乛丿又丶
觌	十乛丶丶大冂见下
奡	一自大丿丨
皕	百百
硪	石我
欹	大丁口⺈人
詟	龙亠一一口
𫐐	车臼儿
辌	车亠口小
棐	非木
龂	止人凵斤
𬹼	止人凵人丿丨
黹	业丶丿丨乛丨丿丶
牚	⺌冂口牙
睎	目乂𠂇巾
晫	日丨一日十
晪	日丨乛一丨丨一八
晱	日火火
𧿹	⻊母
蛑	虫厶牛
畯	田厶八夂
斝	口口冖丶丶十
喤	口白王
崶	山土土寸
嵁	山其上八乛
𫶇	山带上冖巾
崾	山西女
嵅	山戌口
崿	山口口亏
嵚	山钅⺈人
翙	山夕习习
𫖮	山己一丿冂人
圌	囗山而
圐	囗罒方
赑	冂人冂人冂人
淼	水水水
赒	冂人冂土口
鿏	钅龶夂
铹	钅艹冖力
𬭊	钅木土
铽	钅弋心
𨱇	钅求
𫓶	钅口月
锊	钅丿⺍寸
锍	钅亠厶丿丨乛
锎	钅门开
𬭎	钅宀𠂇厶
锓	钅彐冖又
犇	牛牛牛
颋	壬廴一丿冂人
稌	禾人余下
筀	⺮土土
筘	⺮扌口
筜	⺮⺌彐
筥	⺮口口
筅	⺮⺧儿
傃	亻龶幺小
傉	亻厂二乛丿ㄟ寸
翛	亻丨夂习习
傒	亻丿⺍幺大
傕	亻丶乛丿丨亠龶
舾	舟西
畬	人余下田
𫖯	儿冫丿丶一丿冂人
脿	月龶𧘇
腘	月囗玉
䐃	月囗禾
腙	月宀二小
腒	月尸十口
𬱟	⺈厂乛乛一丿冂人
鲃	鱼巴
猰	犭丰刀大
𫛭	犭王鸟
猯	犭山而
㺄	犭人一月刂
馉	饣骨
凓	冫西木
鄗	亠口冂口阝
𫷷	广钅⺈人
廋	广丿丨一乛一一丨又
廆	广鬼
鄌	广乛一一丨口阝
粢	冫⺈人米
遆	辶亠丷冖巾
旐	方丿一儿冫丿丶
𬮱	门西土
焞	火亠口子
𬊤	火丷丨乛一一一丨
欻	火火⺈人
𣸣	氵十艹冂人
溚	氵艹人一口
溁	氵艹冖木
湝	氵比左匕白
渰	氵人一口廾
湓	氵八刀皿
㴔	氵⺈彐心
渟	氵亠口冖丁
溠	氵⺶工
渼	氵⺷大
溇	氵米女
湣	氵民日
湑	氵乛丨一人月
溞	氵叉虫
愐	忄面
愃	忄宀一日一
敩	⺍冖子攵
甯	宀心用
棨	户攵木
扊	户火火
裣	衤人一⺍一
祼	礻果
婻	女十冂丷干
媆	女而大
媞	女日一丨一人
㛹	女亻更
媓	女白王
媂	女亠丷冖巾
媄	女⺷大
毵	厶大丿丿丿毛
矞	龴乛丨丿冂八口
𬴃	马丰石
𫘨	马日一丨一人
缊	纟日皿
缐	纟白水
骙	马乛丶丿丿ㄟ天
瑃	王寿上ㄟ日
瑓	王柬
瑅	王日一丨一人
瑆	王日生
䴖	龶月鸟
瑖	王丿丨一一一几又
瑝	王白王
瑔	王白水
瑀	王禹
𤧛	王亠丷冖巾
瑳	王⺶工
瑂	王乛丨一丿目
嶅	龶乛丿攵山
瑑	王乛乛豕
遘	辶一一丨丨一冉
髢	一丨一二厶丿丿丿也
塥	土一口冂丷一丨
堽	土罒正
赪	土丿丨丿丶丨一冂人
摛	扌亠乂凵丨乛乛丶
塝	土亠丷冖方
搒	扌亠丷冖方
搌	扌尸艹一乛丿ㄟ
蒱	艹扌甫
蒨	艹亻龶月
蓏	艹瓜瓜
蔀	艹立口阝
蓢	艹丶即左月
蓂	艹冖日亠八
蒻	艹弓冫弓冫
蓣	艹龴乛丨一丿冂人
椹	木其上八乛
楪	木世木
榃	木木田
榅	木日皿
楒	木田心
楞	木罒方
楩	木亻更
榇	木立朩
椸	木方丿一也
楙	木龴乛丨丿木
歅	西土⺈人
𬪩	酉农
碃	石龶月
碏	石艹一日
𬒔	石止月
碈	石氏日
䃅	石丷丨乛一一一丨
硿	石宀八工
鄠	雨亏阝
辒	车日皿
𬨎	车丷酉
𫐓	车龴乛丨丿木
龆	止人凵刀口
觜	止匕⺈用
䣘	⺌冖口土阝
暕	日柬
鹍	日比左匕鸟
𫫇	口亚心
㬊	日丿⺍一𠂇又
暅	日忄一日一
跱	⻊土寸
蜐	虫土厶力
蜎	虫口月
嵲	山自木
赗	冂人冂一一目
骱	骨人丿丨
锖	钅龶月
𫓹	钅其上八
锘	钅艹𠂇口
锳	钅艹央
锧	钅丿丿十冂人
锪	钅勿心
𬭚	钅亠口子
锫	钅立口
锬	钅火火
𬭛	钅氵乛丿丨又
稑	禾土八土
稙	禾十具上
䅟	禾厶大丿丿丿
𬕂	⺮工冂人
筻	⺮更
筼	⺮口冂人
筶	⺮⺧口
筦	⺮宀二儿
筤	⺮良
傺	亻丿乛丶丶二小
鹎	丿丨乛一一丿十鸟
僇	亻习习人丿丿丿
艅	舟人余下
艉	舟尸毛
谼	八人口艹一八
貆	豸一日一
腽	月日皿
腨	月山而
腯	月丿丿十目
鲉	鱼由
鲊	鱼乍
鲌	鱼白
䲟	鱼丿乛一卩
𬶋	鱼勹口
𬶍	鱼宀匕
鲏	鱼乛丿丨又
雊	勹口亻亠龶
猺	犭丿⺍缶
飔	几乂田心
觟	⺈用土土
𦝼	月米女
馌	饣土厶皿
裛	亠口巴𧘇
廒	广龶乛丿攵
瘀	疒方人丶丶
瘅	疒丷丨乛一一一丨
鄘	广乛一一丨乛一一丨阝
鹒	广乛一一丿ㄟ鸟
鄜	广乛丨丨一比左匕阝
麀	广乛丨丨一比左匕匕
鄣	立日十阝
阘	门日习习
𫔶	门自木
煁	火其上八乛
煃	火大土土
煴	火日皿
煋	火日生
煟	火田月
煓	火山而
滠	氵耳又又
溍	氵亚日
溹	氵十冖幺小
滆	氵一口冂丷一丨
滉	氵日⺌兀
溦	氵彳山一几攵
溵	氵丿丿彐乛几又
漷	氵亠口子阝
滧	氵亠八乂攵
滘	氵冖八工口
滍	氵乛丨丨一虫
愭	忄耂匕日
慥	忄⺧口辶
慆	忄丿⺍臼
塱	丶即左月土
𫌀	衤龶冂人
裼	衤日勿
禋	礻西土
禔	礻日一丨一人
禘	礻亠丷冖巾
禒	礻乛乛豕
谫	讠丷一月刂刀
鹔	肃鸟
𫖳	尹口一丿冂人
愍	民攵心
嫄	女厂白小
媱	女丿⺍缶
戤	乃又皿戈
勠	习习人丿丿丿力
戣	乛丶丿丿ㄟ天戈
𫘪	马厂白小
𫘬	马丿⺍幺大
缞	纟亠丨乛一一𧘇
耤	耒艹一日
瑧	王寿上ㄟ禾
𫞩	王艹两
瑨	王亚日
瑱	王十具上八
瑷	王丿⺍冖𠂇又
瑢	王宀八人口
斠	一一丨丨一冉丶丶十
摏	扌寿上ㄟ臼
墕	土正一乛灬
墈	土其上八乛力
墐	土廿丨乛一一一丨一
墘	土十日十乞
摴	扌雨亏
銎	工凡金
𡐓	土广乛一一丨冫丿ㄟ
墚	土氵刀丿丶木
撖	扌乛耳攵
𪤗	土习习人丿丿丿
靽	革半
鞁	革乛丿丨又
蔌	艹束⺈人
蔈	艹西二小
蓰	艹彳止丨一人
蔹	艹人一⺍一攵
蔊	艹火日干
嘏	十口乛一丨一一乛一又
榰	木耂匕日
榑	木甫寸
槚	木西冂人
𣗋	木⺌冖口儿
槜	木亻亠龶乃
榍	木尸⺌月
疐	十冖田乛丨一人
𬸘	匚日女鸟
酺	酉甫
酾	酉丽
酲	酉口王
酴	酉人余下
碶	石丰刀大
䃎	石大夕夕
𬒗	石丨丨丿一丶冂见下
碨	石田一乛丿ㄟ
𥔲	石口口亏
碹	石宀一日一
碥	石户冂艹
劂	厂丷一乛丨丿⺈人刂
𫚖	止匕鱼
䴗	目犬鸟
夥	果夕夕
瞍	目丿丨一乛一一丨又
鹖	日勹人乛鸟
㬎	日幺幺灬
跽	⻊己心
蜾	虫果
幖	巾西二小
嶍	山习习白
圙	囗八面
𨱏	钅艹人一口
锺	钅重
锼	钅丿丨一乛一一丨又
锽	钅白王
𬭤	钅亻乛一矢
锾	钅丿⺍一𠂇又
锿	钅亠口𧘇
镃	钅丷一幺幺
镄	钅弗冂人
镅	钅乛丨一丿目
馝	禾日必
鹙	禾火鸟
箨	⺮扌又一一丨
箖	⺮木木
劄	⺮人一口刂
僬	亻亻亠龶灬
僦	亻亠口小尤
僔	亻丷酉寸
僎	亻巳巳艹一八
槃	舟几又木
㙦	人余下丶丶十土
鲒	鱼士口
鲕	鱼而
𫚕	鱼丨丿一巾
鲖	鱼冂一口
鲗	鱼冂人刂
鲘	鱼丿丿一口
鲙	鱼人二厶
𬶐	鱼儿冫丿丶
𬶏	鱼⺈厂乛乛
𩽾	鱼宀女
夐	⺈冂人目夂
獍	犭立日儿
飗	几乂丿乛丶刀田
𬸚	犭讠犬鸟
凘	冫其上八斤
廑	广廿丨乛一一一丨一
廙	广田艹一八
瘗	疒夹土
瘥	疒⺶工
瘕	疒乛一丨一一乛一又
鲝	⺶鱼
鄫	丷囗⺌日阝
熇	火亠口冂口
漹	氵正一乛灬
漖	氵耂子攵
潆	氵艹冖幺小
漤	氵木木女
潩	氵田艹一八
漼	氵山亻亠龶
漴	氵山宀二小
㽏	氵人一口甘
漈	氵丿乛丶丶二小
漋	氵阝夂一生
漻	氵习习人丿丿丿
慬	忄廿丨乛一一一丨一
窬	宀八人一月刂
窭	宀八米女
㮾	丶即左月木
𬤝	讠一丨乛一一丨一丶心
褕	衤人一月刂
禛	礻十具上八
禚	礻⺷灬
隩	阝丿冂米大
嫕	女匚矢心
嫭	女虍乎
嫜	女立日十
嫪	女习习人丿丿丿
𬙂	纟宀一由八
㻬	王雨亏
麹	龶夂勹米
璆	王习习人丿丿丿
漦	未攵厂水
叇	二厶乛一一丨冫丿ㄟ辶
墣	土业⺶ㄟ
墦	土丿米田
墡	土羊丷一口
劐	艹亻亠龶又刂
薁	艹丿冂米大
蕰	艹氵日皿
蔃	艹弓口虫
鼒	才目乛一丿丨一丨乛
槱	木酉灬
鹝	一口冂丷一丨鸟
磏	石丷一乛一一丨丨丿ㄟ
磉	石又又又木
殣	歹廿丨乛一一一丨一
慭	来犬心
霅	雨亠一一口
暵	日廿丨乛一一一丿ㄟ
暲	日立日十
暶	日方丿一乛丨一人
踦	⻊大丁口
踣	⻊立口
䗖	虫带上冖巾
蝘	虫匚日女
蝲	虫束刂
蝤	虫丷酉
噇	口立里
噂	口丷酉寸
噀	口巳巳艹一八
罶	罒丿乛丶刀田
嶲	山亻亠龶丨乛丨乛
嶓	山丿米田
㠇	山亠口小尤
嶟	山丷酉寸
嶒	山丷囗⺌日
镆	钅艹日大
镈	钅甫寸
镋	钅⺌冖口儿
镎	钅人一口手
𬭩	钅八厶习习
镕	钅宀八人口
稹	禾十具上八
儇	亻罒一口𧘇
皞	白白大十
皛	白白白
䴘	丿丿虍几鸟
艎	舟白王
艏	舟丷一自
鹟	八厶习习鸟
𩾃	鱼⺈丨乛一丿乛
鲦	鱼夂朩
鲪	鱼尹口
鲬	鱼龴用
橥	犭耂日木
觭	⺈用大丁口
鹠	丿乛丶刀田鸟
鹡	冫丿丶人月鸟
糇	米亻乛一矢
糈	米乛丨一人月
翦	丷一月刂习习
鹢	丷一八皿鸟
鹣	丷一乛一一丨丨丿ㄟ鸟
熛	火西二小
潖	氵王王巴
潵	氵艹一月攵
㵐	氵厂丷一乛丨丿⺈人
澂	氵山一王攵
澛	氵鱼日
瑬	氵亠厶丿丨乛玉
潽	氵丷亚日
潾	氵米夕一乛丨
潏	氵龴乛丨丿冂八口
憭	忄大丶丿日小
憕	忄乛丶丿丿ㄟ一口丷一
𬸣	宀一一丨丨一八鸟
戭	宀一由八戈
褯	衤广廿巾
禤	礻罒习习
𫍽	讠罒一口𧘇
嫽	女大丶丿日小
遹	辶龴乛丨丿冂八口
𬴊	马米夕一乛丨
璥	王艹勹口攵
璲	王丷豕辶
璒	王乛丶丿丿ㄟ一口丷一
憙	士口丷一口心
擐	扌罒一口𧘇
鄹	耳又亻丿丿丿ㄟ阝
薳	艹土口𧘇辶
鞔	革⺈丨乛一丿乛
黇	艹一由八丨一口
𬞟	艹止丨丿丿一丿冂人
蕗	艹⻊夂口
薢	艹⺈用刀牛
蕹	艹亠乡亻亠龶
橞	木一丨乛一一丨一丶心
橑	木大丶丿日小
橦	木立里
醑	酉乛丨一人月
觱	戌口⺈用
磡	石其上八乛力
𥕢	石一丨乛一丨丨一日
磜	石丿乛丶丶二小
豮	豕十艹冂人
𫟦	车丷豕辶
𬺈	止人凵大丁口
𫠜	止人凵臼儿
鹾	丨一囗乂⺶工
虤	虍几虍几
暿	日士口丷一口
曌	日月宀八工
曈	日立里
㬚	日亠厶月攵
蹅	⻊木日一
踶	⻊日一丨一人
䗛	虫亻丨夂月
螗	虫广乛一一丨口
疁	田习习人丿丿丿
㠓	山艹冖二丿乛丿丿丿ㄟ
幪	巾艹冖二丿乛丿丿丿ㄟ
𪩘	山十冂丷干犬
嶦	山⺈厂八亠一一口
𬭬	钅丰丰彐
𨱑	钅艹一由八
𬭯	钅丶丿丨乛丨丿丶攵
馞	禾日十冖子
穄	禾丿乛丶丶二小
篚	⺮匚非
篯	⺮钅戋
簉	⺮⺧口辶
鼽	自田一丿丨九
衠	彳十具上八亍
盦	人丶乛酉皿
螣	月龹虫
縢	月龹幺小
鲭	鱼龶月
鲯	鱼其上八
鲰	鱼耳又
鲺	鱼乛丿虫
鲹	鱼厶大丿丿丿
𫗴	饣亠囗口日一
亸	亠口子丷丨乛一一一丨
癀	疒艹一由八
瘭	疒西二小
𬸦	方丿一矢鸟
羱	⺶厂白小
糒	米艹一丿用
燋	火亻亠龶灬
熻	火人一口习习
燊	火火火木
燚	火火火火
燏	火龴乛丨丿冂八口
濩	氵艹亻亠龶又
濋	氵木木乛丨一人
澪	氵雨人丶龴
澽	氵虍豕
澴	氵罒一口𧘇
澭	氵亠乡亻亠龶
澼	氵尸口立十
憷	忄木木乛丨一人
憺	忄⺈厂八亠一一口
懔	忄亠囗口二小
黉	⺍冖艹一由八
嬛	女罒一口𧘇
鹨	习习人丿丿丿鸟
翯	习习亠口冂口
𫄷	纟立日心
璱	王王王必
𤩽	王十冂丷干犬
璬	王白方攵
璮	王亠囗口日一
髽	一丨一二厶丿丿丿人人土
擿	扌亠丷冂十口辶
薿	艹匕矢龴乛丨一人
薸	艹氵西二小
檑	木雨田
櫆	木鬼丶丶十
檞	木⺈用刀牛
醨	酉亠乂凵丨乛乛丶
繄	匚矢几又幺小
磹	石西日十
磻	石丿米田
瞫	目西日十
瞵	目米夕一乛丨
蹐	⻊冫丿丶人月
蟏	虫艹肃
㘎	口门乛耳攵
𬭳	钅士口丷一口
镤	钅业⺶ㄟ
𬭶	钅黑
𫔍	钅丿米田
镥	钅鱼日
镨	钅丷亚日
𬭸	钅米夕一乛丨
𨱔	钅丷酉寸
𬭼	钅丷豕辶
𫔎	钅龴乛丨丿冂八口
矰	矢丷囗⺌日
穙	禾业⺶ㄟ
穜	禾立里
穟	禾丷豕辶
簕	⺮革力
簃	⺮禾夕夕
簏	⺮广乛丨丨一比左匕
儦	亻广乛丨丨一比左匕灬
魋	鬼亻亠龶
斶	斤罒勹虫
艚	舟一丨乛一丨丨一日
𬸪	丿米田鸟
谿	丿⺍幺大八人口
䲠	鱼寿上ㄟ日
𬶟	鱼束刂
鲾	鱼一口田
𬶠	鱼柬
鲿	鱼⺌冖二厶
鳁	鱼日皿
鳂	鱼田一乛丿ㄟ
鳈	鱼白水
鳉	鱼冫丨夕寸
獯	犭丿一丨乛丶丿一丨一一灬
䗪	广廿灬虫
馘	丷一自戈口一
襕	衤门柬
襚	衤丷豕辶
𬶨	即左一乛丿乛鱼
螱	尸二小寸虫
甓	尸口立十瓦
嬬	女雨而
嬥	女习习亻亠龶
𦈡	纟雨而
𫄸	纟丿一丨乛丶丿一丨一一灬
瓀	王雨而
釐	未攵厂里
鬶	夫冂见下一口冂丷一丨
爇	艹土八土丸灬
鞳	革艹人一口
鞮	革日一丨一人
𬟁	艹一口冂丷一丨鸟
藟	艹田田田
藦	艹广木木手
藨	艹广乛丨丨一比左匕灬
鹲	艹冖二丿乛丿丿丿ㄟ鸟
檫	木宀丿乛丶丶二小
黡	厂犬黑
礞	石艹冖二丿乛丿丿丿ㄟ
礌	石雨田
𥖨	石口口口木
蹢	⻊亠丷冂十口
蹜	⻊宀亻百
蟫	虫西日十
䗴	虫⺮壬廴
嚚	口口臣口口
髃	骨禺
镮	钅罒一口𧘇
镱	钅立日心
酂	⺧儿⺧儿冂人阝
馧	禾日日皿
簠	⺮甫皿
簝	⺮大丶丿日小
簰	⺮片丿丨乛一一丿十
鼫	臼乛丶丶乛丶丶乛石
鼩	臼乛丶丶乛丶丶乛勹口
皦	白白方攵
臑	月雨而
䲢	月龹鱼
鳑	鱼亠丷冖方
鳒	鱼丷一乛一一丨丨丿ㄟ
鹱	鸟艹亻亠龶又
鹯	亠囗口日一鸟
癗	疒雨田
𦒍	立里习习
旞	方丿一丷豕辶
翷	米夕一乛丨习习
冁	丷丨乛一一一丨尸艹一乛丿ㄟ
䎖	丷囗⺌日习习
瀔	氵士冖一禾几又
瀍	氵广里八土
瀌	氵广乛丨丨一比左匕灬
襜	衤⺈厂八亠一一口
䴙	尸口立十鸟
𬙊	纟黑土
嚭	士口丷一口不口
㰀	木禾勹丿人氺
鬷	一口冂丷一丨乂凵八夂
醭	酉业⺶ㄟ
蹯	⻊丿米田
蠋	虫罒勹虫
翾	罒一口𧘇习习
鳘	丿一母攵鱼
儳	亻⺈口比左匕⺈丨乛一丿乛丶
儴	亻亠口口一一丨丨一𧘇
鼗	儿冫丿丶士口丷一十又
𬶭	鱼丿乛丶丶二小
𩾌	鱼广乛一一丨冫丿ㄟ
鳚	鱼尸二小寸
鳛	鱼习习白
麑	广乛丨丨一比左匕臼儿
麖	广乛丨丨一比左匕亠口小
蠃	亡口月虫凡
彟	彐寸艹亻亠龶又
嬿	女廿口丨一一匕灬
鬒	一丨一二厶丿丿丿十具上八
蘘	艹亠口口一一丨丨一𧘇
欂	木艹氵甫寸
醵	酉虍豕
颥	雨而一丿冂人
甗	虍一口冂丷一丨瓦
𨟠	目目亻亠龶阝
巇	山虍一口丷一戈
酅	山亻亠龶冂八口阝
髎	骨习习人丿丿丿
犨	亻亠龶亻亠龶牛
𬶮	鱼士口丷一口
𨭉	文一弋止金
㸌	火雨亻亠龶
爔	火⺷丿一丨丿丶一乛乛丿丶
瀱	氵罒厂火火刂
瀹	氵人一口口口冂艹
瀼	氵亠口口一一丨丨一𧘇
瀵	氵米田艹一八
襫	衤大百百
孅	女人人戈韭
骦	马雨木目
𬙋	纟亠口口一一丨丨一𧘇
耰	耒一丿丨乛一一冖心夂
𤫉	王火亠一一口火又
瓖	王亠口口一一丨丨一𧘇
鬘	一丨一二厶丿丿丿日罒又
趯	土丨一人习习亻亠龶
𬺓	止人凵木木乛丨一人
罍	田田田缶
鼱	臼乛丶丶乛丶丶乛龶月
鳠	鱼艹亻亠龶又
鳡	鱼戌口心
鳣	鱼亠囗口日一
爟	火艹口口亻亠龶
爚	火人一口口口冂艹
灈	氵目目亻亠龶
韂	革⺈厂八亠一一口
糵	艹丿㠯立十米
蘼	艹广木木非
礵	石雨木目
鹴	雨木目鸟
躔	⻊广里八土
皭	白丿⺍罒即左寸
龢	人一口口口冂艹禾
鳤	鱼⺮宀㠯
亹	亠丿丨一一冂一口乛一一冖且
籥	⺮人一口口口冂艹
鼷	臼乛丶丶乛丶丶乛丿⺍幺大
𫚭	鱼乛乛乛囗乂乛丶丶乛丶丶乛
玃	犭目目亻亠龶又
醾	酉广木木米
齇	自田一丿丨虍且
觿	⺈用山亻亠龶冂八口
蠼	虫目目亻亠龶又