𤭢	亠人人十瓦
𰻝	辶穴月幺长言马幺长刂心
嬢	女衣八𠀎
薙	艹矢亻{隹右}
菈	艹扌立
卻	谷卩
濛	氵艹冖一豕
诶	讠厶矢
凃	冫𠆢一朩
咲	口丷天
螓	虫𡗗禾
珮	𤣩𠘨一巾
睆	目宀元
挼	扌爫女
嗯	口因心
欸	厶矢欠
哟	口纟勺
唷	口亠厶⺝
育	亠厶⺝
啊	口⻖可
阿	⻖可
吖	口丫
锕	钅⻖可
腌	⺼大电
爱	爫冖𠂇又
艾	艹乂
哎	口艹乂
唉	口厶矢
哀	衣口
挨	扌厶矢
埃	土厶矢
矮	矢禾女
碍	石旦寸
暧	日爫冖𠂇又
癌	疒口口口山
蔼	艹讠曰勹𠃊人
隘	⻖丷一八皿
皑	白山己
霭	雨讠曰勹𠃊人
嗳	口爫冖𠂇又
嫒	女爫冖𠂇又
毐	士毋
叆	云爫冖𠂇又
瑷	𤣩爫冖𠂇又
砹	石艹乂
锿	钅衣口
嗌	口丷一八皿
按	扌宀女
安	宀女
暗	日立日
案	宀女木
岸	山厂干
俺	亻大电
黯	{里}灬立日
庵	广大电
鞍	革宀女
谙	讠立日
氨	气宀女
胺	⺼宀女
鹌	大电鸟
桉	木宀女
犴	犭干
唵	口大电
铵	钅宀女
埯	土大电
盦	𠆢一㇇酉皿
垵	土宀女
𩽾	鱼宀女
昂	日丿𠄌卩
肮	⺼亠几
盎	央皿
卬	丿𠄌卩
傲	亻龶{⺈}攵
奥	丿⺆米大
熬	龶{⺈}攵灬
敖	龶{⺈}攵
澳	氵丿冂釆大
凹	丨㇅丨𠃍一
懊	忄丿冂釆大
嗷	口龶{⺈}攵
拗	扌幺力
袄	衤夭
鳌	龶{⺈}攵鱼
翱	白大十习习
獒	龶{⺈}攵犬
骜	龶{⺈}攵马
坳	土幺力
鏖	鹿金
遨	辶龶{⺈}攵
媪	女日皿
螯	龶{⺈}攵虫
岙	夭山
璈	𤣩龶{⺈}攵
鏊	龶{⺈}攵金
聱	龶{⺈}攵耳
廒	广龶{⺈}攵
奡	𦣻大{⿰丿丨}
隩	⻖丿冂釆大
薁	艹丿冂釆大
嶅	龶{⺈}攵山
把	扌巴
吧	口巴
八	丿乀
爸	父巴
巴	巳丨
罢	罒去
拔	扌𠂇丶又
霸	雨革月
疤	疒巴
跋	𧾷𠂇丶又
扒	扌八
叭	口八
芭	艹巴
靶	革巴
坝	土贝
耙	耒巴
笆	竹巴
魃	鬼𠂇丶又
粑	米巴
钯	钅巴
灞	氵雨革月
捌	扌口力刂
鲅	鱼𠂇丶又
岜	山巴
鲃	鱼巴
菝	艹扌𠂇丶又
蚆	虫巴
胈	⺼𠂇丶又
羓	羊巴
朳	木八
妭	女𠂇丶又
白	丿日
百	一白
败	贝攵
摆	扌罒去
拜	龵一丰
柏	木白
掰	手分手
伯	亻白
佰	亻百
稗	禾{卑上}十
捭	扌{卑上}十
半	丷𰀁
办	力八
般	舟殳
板	木𠂆又
班	𤣩王リ
伴	亻半
版	片𠂆又
搬	扌舟殳
扮	扌分
斑	𤣩王文
扳	扌𠂆又
瓣	辛辛瓜
绊	纟半
颁	分页
拌	扌半
阪	⻖𠂆又
坂	土𠂆又
瘢	疒舟殳
钣	钅𠂆又
癍	疒𤣩王文
攽	分攵
柈	木半
昄	日𠂆又
湴	氵丷一业
靽	革半
𨭉	文戈一止金
帮	丰⻏巾
膀	⺼亠丷冖方
邦	丰⻏
棒	木𡗗𰀁
绑	纟丰⻏
榜	木亠丷冖方
傍	亻亠丷冖方
磅	石亠丷冖方
梆	木丰⻏
镑	钅亠丷冖方
谤	讠亠丷冖方
蚌	虫丰
浜	氵丘八
蒡	艹亠丷冖方
玤	𤣩丰
搒	扌亠丷冖方
塝	土亠丷冖方
𠳐	口丰⻏
保	亻口木
报	扌卩又
包	勹巳
宝	宀玉
抱	扌包
暴	日共氺
爆	火日共氺
薄	艹氵甫寸
堡	亻口木土
饱	饣包
豹	豸勺
胞	⺼包
剥	彐⺢刂
鲍	鱼包
褒	衣亻口木
刨	包刂
苞	艹包
鸨	匕十鸟
曝	日日共氺
煲	亻口木火
葆	艹亻口木
雹	雨包
褓	衤亻口木
炮	火包
龅	止凵人包
孢	子包
趵	𧾷勺
枹	木包
瀑	氵日共氺
被	衤皮
备	夂田
北	{北左}匕
背	北⺝
呗	口贝
杯	木不
辈	非车
悲	非心
贝	冂人
倍	亻立口
卑	{卑上}十
惫	夂田心
碑	石{卑上}十
狈	犭贝
蓓	艹亻立口
悖	忄十冖子
孛	十冖子
焙	火立口
邶	北⻏
陂	⻖皮
钡	钅贝
褙	衤北⺝
碚	石立口
鞴	革卄一丿用
鐾	尸口辛金
鹎	{卑上}十鸟
棓	木立口
糒	米卄一丿用
琲	𤣩非
椑	木{卑上}十
臂	尸口辛⺝
鞁	革皮
𬇙	氵贝
本	木一
奔	大十廾
笨	竹本
贲	十廾贝
苯	艹本
锛	钅大十廾
畚	厶大田
犇	牛牜牛
坌	分土
倴	亻大十廾
栟	木丷开
夯	大力
崩	山月月
蹦	𧾷山月月
绷	纟月月
迸	辶丷开
甭	不用
嘣	口山月月
泵	石水
镚	钅山月月
甏	士口䒑彡瓦
琫	𤣩𡗗𰀁
祊	礻方
比	匕匕
必	心丿
毕	匕匕十
笔	竹毛
避	辶尸口辛
闭	门才
鼻	自田丌
逼	辶𠮛田
屄	尸宀八
壁	尸口辛土
彼	彳皮
碧	𤣩白石
币	丿巾
陛	⻖匕匕土
鄙	口亠囗口⻏
蔽	艹⺌冂小攵
匕	丿乚
毙	匕匕歹匕
辟	尸口辛
婢	女{卑上}十
弊	⺌冂小攵廾
璧	尸口辛玉
庇	广匕匕
敝	⺌冂小攵
痹	疒田丌
弼	弓弓百
俾	亻{卑上}十
裨	衤{卑上}十
薜	艹尸口辛
哔	口匕匕十
愎	忄𠂉日夂
吡	口匕匕
跸	𧾷匕匕十
妣	女匕匕
篦	竹丿囗㐅匕匕
荜	艹匕匕十
狴	犭匕匕土
毖	匕匕必
蓖	艹丿囗㐅匕匕
嬖	尸口辛女
筚	竹匕匕十
髀	冎⺼{卑上}十
荸	艹十冖子
濞	氵自田丌
畀	田丌
赑	贝贝贝
秕	禾匕匕
箅	竹田丌
芘	艹匕匕
佛	亻弗
襞	尸口辛衣
苾	艹必
滗	氵竹毛
铋	钅必
庳	广{卑上}十
萆	艹{卑上}十
皕	百百
咇	口必
舭	舟匕匕
沘	氵匕匕
珌	𤣩必
觱	戊{一}口⺈用
诐	讠皮
邲	必⻏
佖	亻必
馝	禾日必
坒	匕匕土
泌	氵必
秘	禾必
鲾	鱼𠮛田
边	辶力
便	亻更
变	亠{亦下}又
遍	辶户冂卄
编	纟户冂卄
辩	辛辛讠
鞭	革亻更
辨	辛辛リ
扁	户冂卄
辫	辛辛纟
贬	贝乏
蝙	虫户冂卄
匾	匚户冂卄
卞	亠卜
汴	氵亠卜
弁	厶廾
砭	石乏
煸	火户冂卄
褊	衤户冂卄
笾	竹辶力
鳊	鱼户冂卄
昪	日厶廾
忭	忄亠卜
苄	艹亠卜
抃	扌亠卜
碥	石户冂卄
萹	艹户冂卄
𨚕	厶廾⻏
表	龶𧘇
标	木示
镖	钅覀示
彪	虍几彡
飙	犬犬犬风
婊	女龶𧘇
骠	马覀示
镳	钅鹿灬
膘	⺼覀示
裱	衤龶𧘇
杓	木勺
飑	风包
俵	亻龶𧘇
鳔	鱼覀示
摽	扌覀示
瘭	疒覀示
熛	火覀示
藨	艹鹿灬
儦	亻鹿灬
骉	马马马
瀌	氵鹿灬
幖	巾覀示
脿	⺼龶𧘇
别	口力刂
憋	⺌冂小攵心
瘪	疒自仑
鳖	⺌冂小攵鱼
蹩	⺌冂小攵足
癿	白乚
宾	宀丘八
彬	木木彡
斌	文戈一止
滨	氵宀丘八
鬓	E一厶彡宀丘八
缤	纟宀丘八
镔	钅宀丘八
濒	氵止𣥂页
槟	木宀丘八
殡	歹宀丘八
膑	⺼宀丘八
摈	扌宀丘八
玢	𤣩分
傧	亻宀丘八
豳	山豕豕
邠	分⻏
髌	冎⺼宀丘八
并	丷开
兵	丘八
冰	冫水
病	疒一内
柄	木一内
饼	饣丷开
禀	亠囗口示
秉	千⺕人
丙	一内
炳	火一内
摒	扌尸丷开
屏	尸丷开
邴	丙⻏
昺	日一内
蛃	虫一内
波	氵皮
博	十甫寸
脖	⺼十冖子
拨	扌{𠃊丿}丶又
播	扌釆田
勃	十冖子力
玻	𤣩皮
膊	⺼甫寸
搏	扌甫寸
驳	马乂乂
泊	氵白
簸	竹卄二一八皮
帛	白巾
钵	钅本
跛	𧾷皮
渤	氵十冖子力
菠	艹氵皮
礴	石艹氵甫寸
啵	口氵皮
舶	舟白
卜	丨丶
饽	饣十冖子
铂	钅白
钹	钅𠂇丶又
箔	竹氵白
亳	亠口冖丿七
擘	尸口辛手
檗	尸口辛木
鹁	十冖子鸟
僰	朿朿人
踣	𧾷立口
镈	钅甫寸
砵	石本
鲌	鱼白
哱	口十冖子
嶓	山釆田
浡	氵十冖子
馞	禾日十冖子
艴	弗⺈巴
蕃	艹釆田
欂	木艹氵甫寸
袯	衤{𠃊丿}丶又
𬭛	钅氵皮
不	丆卜
部	立口⻏
步	止𣥂
布	𠂇巾
补	衤卜
怖	忄𠂇巾
捕	扌甫
簿	竹氵甫寸
埔	土甫
哺	口甫
埠	土阜
卟	口卜
逋	辶甫
钚	钅不
晡	日甫
瓿	立口瓦
醭	酉业䒑夫
蔀	艹立口⻏
埗	土止𣥂
𬷕	甫鸟
擦	扌宀𱼀龴示
嚓	口宀𱼀龴示
才	𬺰丿
菜	艹采
彩	采彡
采	爫木
财	贝才
材	木才
猜	犭龶⺝
蔡	艹𱼀龴示
裁	戈十衣
踩	𧾷采
睬	目采
偲	亻田心
参	厶大彡
残	歹戋
惨	忄厶大彡
餐	歺又𠆢丶艮
灿	火山
惭	忄车斤
蚕	天虫
璨	𤣩歺又米
粲	歺又米
骖	马厶大彡
黪	{里}灬厶大彡
䅟	禾厶大彡
藏	艹𠃊丆戊臣
苍	艹𠆢㔾
仓	𠆢㔾
舱	舟𠆢㔾
沧	氵𠆢㔾
伧	亻𠆢㔾
鸧	仑{鳥-灬}灬
草	艹日十
操	扌口口口木
肏	入肉
艹	一〢
曹	艹曲曰
嘈	口艹曲曰
糙	米辶⺧口
槽	木艹曲曰
漕	氵艹曲曰
屮	凵丨
芔	屮屮屮
艚	舟艹曲曰
螬	虫艹曲曰
𥕢	石艹曲曰
测	氵贝刂
侧	亻贝刂
册	⺆⺆一
策	竹朿
厕	厂贝刂
恻	忄贝刂
岑	山𠆢一㇇
涔	氵山𠆢一㇇
曾	丷囗⺌日
层	尸云
蹭	𧾷丷囗⺌日
噌	口丷囗⺌日
嶒	山丷囗⺌日
差	⺶工
查	木旦
察	宀𱼀龴示
茶	艹𠆢朩
插	扌千臼
诧	讠宀丿七
叉	又丶
岔	分山
茬	艹𠂇丨土
衩	衤叉
碴	石木旦
姹	女宀丿七
杈	木叉
搽	扌艹𠆢朩
刹	㐅木刂
檫	木宀𱼀龴示
槎	木⺶工
汊	氵叉
镲	钅宀𱼀龴示
锸	钅千臼
馇	饣木旦
垞	土宀丿七
侘	亻宀丿七
猹	犭木旦
蹅	𧾷木旦
嵖	山木旦
喳	口木旦
𥻗	米木旦
拆	扌斥
柴	止匕木
钗	钅叉
豺	豸才
侪	亻齐
茝	艹𦣞
虿	万虫
瘥	疒⺶工
产	亠丷厂
颤	亠囗口旦页
缠	纟广里
禅	礻𭕄田十
蝉	虫丷田十
搀	扌⺈𫩏儿⺀
铲	钅亠丷厂
婵	女丷田十
掺	扌厶大彡
阐	门丷田十
忏	忄千
馋	饣⺈𫩏儿⺀
潺	氵尸子子子
蟾	虫⺈厂八亠二口
谄	讠⺈臼
谗	讠⺈𫩏儿⺀
孱	尸子子子
冁	丷田十尸卄一{𧘇-丿}
澶	氵亠囗口旦
觇	占见
镡	钅覀日十
羼	尸羊⺶羊
廛	广里八土
巉	山⺈口匕匕兔
蒇	艹戊贝
韂	革⺈厂八亠二口
躔	𧾷广里八土
刬	戋刂
浐	氵亠丷厂
襜	衤⺈厂八亠二口
瀍	氵广里八土
骣	马尸子子子
镵	钅⺈口匕匕兔
旵	日山
啴	口丷田十
梴	木廴正
儳	亻⺈口匕匕兔
单	丷田十
辿	辶山
𬊤	火丷田十
长	丿一𠄌ㄟ
常	龸口巾
场	土𠄎丿丿
唱	口日曰
厂	一丿
尝	龸云
昌	日曰
畅	申𠄎丿丿
肠	⺼𠄎丿丿
偿	亻龸云
敞	⺌冂口攵
怅	忄长
倡	亻日曰
娼	女日曰
嫦	女龸口巾
猖	犭日曰
昶	永日
徜	彳⺌冂口
氅	⺌冂口攵毛
伥	亻长
裳	龸口衣
菖	艹日曰
苌	艹长
阊	门日曰
鬯	凵㐅丶丶丶丶匕
惝	忄⺌冂口
鲳	鱼日曰
鲿	鱼龸云
𬬮	钅长
超	土龰刀口
朝	十十日月
潮	氵十十日月
吵	口少
嘲	口十十日月
抄	扌少
炒	火少
巢	巛果
钞	钅少
晁	日兆
焯	火⺊日十
耖	耒少
怊	忄刀口
弨	弓刀口
绰	纟⺊日十
车	一𠃊十
彻	彳七刀
扯	扌止
撤	扌亠厶⺝攵
澈	氵亠厶⺝攵
掣	牛冂刂手
砗	石车
坼	土斥
尺	尸乀
㬚	日亠厶⺝攵
沉	氵冖几
陈	⻖东
臣	匚コ丨丨
晨	日辰
尘	小土
趁	土龰𠆢彡
辰	厂二{𧘇-丿}
衬	衤寸
嗔	口十{具-八}八
琛	𤣩⺳木
称	禾⺈小
宸	宀辰
忱	忄冖儿
抻	扌申
碜	石厶大彡
谌	讠卄二匸八
谶	讠戈人人韭
郴	木木⻏
棽	木木𠆢一㇇
瞋	目十{具-八}八
榇	木立木
龀	止凵人匕
疢	疒火
梣	木山𠆢一㇇
煁	火卄二匸八
𬘭	纟木木
成	戊𠃌
城	土成
程	禾口王
承	了三㇇丿乀
诚	讠成
盛	成皿
乘	千北人
撑	扌龸口手
呈	口王
惩	彳正心
丞	了水一
澄	氵癶一口䒑
逞	辶口王
橙	木癶一口䒑
骋	马由丂
瞠	目龸口土
秤	禾平
铖	钅成
塍	月龹土
琤	𤣩⺈{肀亅}
裎	衤口王
澂	氵山一王攵
埕	土口王
柽	木又土
蛏	虫又土
酲	酉口王
枨	木长
珵	𤣩口王
赪	赤⺊贝
偁	亻爫冉
宬	宀成
牚	龸口牙
珹	𤣩成
憕	忄癶一口䒑
庱	广土儿夂
晟	日成
铛	钅⺌彐
吃	口𠂉乙
持	扌土寸
迟	⻌尺
赤	土{亦下}
痴	疒矢口
池	氵也
齿	止凵人
斥	斤丶
驰	马也
耻	耳止
翅	支习习
哧	口赤
炽	火只
嗤	口屮一虫
蚩	屮一虫
叱	口𠤎
弛	弓也
侈	亻夕夕
啻	亠丷冖巾口
敕	束攵
螭	虫亠凶禸
魑	鬼亠凶禸
饬	饣𠂉力
笞	竹厶口
匙	日一龰匕
踟	𧾷矢口
墀	土尸八小牛
豉	豆支
媸	女屮一虫
褫	衤𠂆虍几
鸱	氐鸟
彳	丿亻
茌	艹亻士
篪	竹𠂆虍几
瘛	疒丰刀心
摛	扌亠凶禸
眵	目夕夕
傺	亻𱼀龴示
漦	未攵厂水
胣	⺼𠂉也
瓻	㐅𠂇巾瓦
痓	疒𠫔土
𫄨	纟㐅𠂇巾
冲	冫中
充	亠允
重	千里
虫	中一丶
崇	山宀示
宠	宀龙
忡	忄中
憧	忄立里
铳	钅亠允
舂	𡗗臼
艟	舟立里
翀	习习中
茺	艹亠允
珫	𤣩亠允
漴	氵山宀示
涌	氵龴用
种	禾中
㳘	氵亠允
摏	扌𡗗臼
抽	扌由
仇	亻九
臭	自犬
丑	𠃍土
愁	禾火心
筹	竹{寿上丰}寸
瞅	目禾火
酬	酉州
绸	纟⺆土口
畴	田{寿上丰}寸
踌	𧾷{寿上丰}寸
惆	忄⺆土口
稠	禾⺆土口
俦	亻{寿上丰}寸
雠	亻{隹右}亻{隹右}讠
瘳	疒习习𠆢彡
犨	亻{隹右}亻{隹右}牛
帱	巾{寿上丰}寸
杻	木丑
侴	𠆢一丑刂
椆	木⺆土口
出	山山
处	夂卜
楚	木木疋
除	⻖𠆢一朩
初	衤刀
触	⺈用虫
厨	厂豆寸
础	石出
储	亻讠耂日
畜	玄田
褚	衤耂日
搐	扌玄田
橱	木厂豆寸
躇	𧾷艹耂日
雏	⺈彐亻{隹右}
锄	钅且力
矗	十{具-八}直十{具-八}
杵	木𠂉十
楮	木耂日
怵	忄术
黜	{里}灬出
绌	纟出
蜍	虫𠆢一朩
刍	⺈彐
滁	氵⻖𠆢一朩
樗	木雨一丂
蹰	𧾷厂豆寸
憷	忄木木疋
亍	一丁
俶	亻上小又
斶	斤⺫勹虫
摴	扌雨一丂
䝙	豸区
䢺	出⻏
濋	氵木木疋
琡	𤣩上小又
𬺓	止凵人木木疋
欻	火火欠
揣	扌山而
踹	𧾷山而
搋	扌𠂆虍几
啜	口又又又又
传	亻专
穿	宀八牙
船	舟𠘧口
川	丿〢
喘	口山而
串	口口丨
钏	钅川
椽	木彑𧰨
舛	夕㐄
遄	辶山而
氚	气川
床	广木
窗	宀八丿囗夂
创	𠆢㔾刂
疮	疒𠆢㔾
闯	门马
怆	忄𠆢㔾
幢	巾立里
噇	口立里
吹	口欠
垂	千艹士
锤	钅千艹士
捶	扌千艹士
炊	火欠
槌	木辶𠂤
陲	⻖千艹士
棰	木千艹士
倕	亻千艹士
圌	囗山而
春	𡗗日
纯	纟屯
唇	辰口
蠢	𡗗日虫虫
淳	氵亠口子
醇	酉亠口子
椿	木𡗗日
鹑	亠口子鸟
莼	艹纟屯
蝽	虫𡗗日
瑃	𤣩𡗗日
䲠	鱼𡗗日
堾	土𡗗日
𬭚	钅亠口子
戳	习习亻{隹右}戈
龊	止凵人足
辍	车又又又又
踔	𧾷⺊日十
惙	忄又又又又
逴	辶⺊日十
此	止匕
次	冫欠
刺	朿刂
词	讠𠃌一口
辞	舌辛
慈	丷一幺幺心
赐	贝日勿
磁	石丷一幺幺
伺	亻𠃌一口
瓷	冫欠瓦
茨	艹冫欠
雌	止匕亻{隹右}
祠	礻𠃌一口
呲	口止匕
疵	疒止匕
泚	氵止匕
糍	米丷一幺幺
鹚	丷一幺幺鸟
茈	艹止匕
跐	𧾷止匕
玼	𤣩止匕
佽	亻冫欠
兹	丷一幺幺
莿	艹朿刂
𫚖	止匕鱼
从	人人
匆	勹丿丿丶
聪	耳丷口心
丛	人人一
葱	艹勹丿丿丶心
琮	𤣩宀示
淙	氵宀示
囱	丿囗夂
骢	马丿囗夂心
苁	艹人人
枞	木人人
璁	𤣩丿囗夂心
熜	火丿囗夂心
悰	忄宀示
凑	冫𡗗天
辏	车𡗗天
腠	⺼𡗗天
粗	米且
促	亻足
醋	酉卄一日
簇	竹方𠂉矢
猝	犭亠人人十
蹙	戊上小足
蹴	𧾷亠口小尤
卒	亠人人十
徂	彳且
殂	歹且
蔟	艹方𠂉矢
窜	宀八串
蹿	𧾷宀八串
篡	竹目大厶
撺	扌宀八串
攒	扌⺧儿⺧儿贝
汆	入水
爨	𦥑同木木大火
镩	钅宀八串
脆	⺼⺈厂㔾
催	亻山亻{隹右}
翠	习习亠人人十
崔	山亻{隹右}
摧	扌山亻{隹右}
粹	米亠人人十
悴	忄亠人人十
璀	𤣩山亻{隹右}
啐	口亠人人十
萃	艹亠人人十
瘁	疒亠人人十
淬	氵亠人人十
榱	木衣{⿻口一}
毳	毛毛毛
漼	氵山亻{隹右}
缞	纟衣{⿻口一}
存	𠂇丨子
村	木寸
寸	𬺰丶
忖	忄寸
皴	允夂皮
邨	屯⻏
错	钅卄一日
措	扌卄一日
挫	扌土人人
搓	扌⺶工
撮	扌日耳又
磋	石⺶工
蹉	𧾷⺶工
锉	钅土人人
厝	厂卄一日
矬	矢土人人
嵯	山⺶工
痤	疒土人人
鹾	⺊口㐅⺶工
脞	⺼土人人
瑳	𤣩⺶工
棤	木卄一日
莝	艹土人人
大	一人
打	扌丁
答	竹𠆢一口
达	辶大
搭	扌艹𠆢一口
哒	口辶大
瘩	疒艹𠆢一口
嗒	口艹𠆢一口
沓	水日
耷	大耳
鞑	革辶大
靼	革旦
妲	女旦
褡	衤艹𠆢一口
跶	𧾷辶大
怛	忄旦
笪	竹旦
垯	土辶大
溚	氵艹𠆢一口
炟	火旦
荙	艹辶大
鿎	石辶大
𨱏	钅艹𠆢一口
𫟼	钅辶大
带	{卅}冖巾
代	亻弋
待	彳土寸
呆	口木
袋	亻弋衣
戴	戈十田共
黛	亻弋{里}灬
歹	一夕
贷	亻弋贝
逮	辶隶
怠	厶口心
殆	歹厶口
岱	亻弋山
玳	𤣩亻弋
呔	口太
傣	亻𡗗氺
迨	辶厶口
绐	纟厶口
叇	云辶隶
埭	土隶
骀	马厶口
轪	车大
垈	亻弋土
但	亻旦
淡	氵火火
担	扌旦
弹	弓丷田十
丹	⺆一丶
蛋	疋虫
胆	⺼旦
旦	日一
诞	讠廴正
耽	耳冖儿
惮	忄丷田十
石	丆口
眈	目冖儿
澹	氵⺈厂八亠二口
掸	扌丷田十
郸	丷田十⻏
殚	歹丷田十
啖	口火火
氮	气火火
儋	亻⺈厂八亠二口
聃	耳冉
箪	竹丷田十
亶	亠囗口旦
疸	疒旦
萏	艹⺈臼
瘅	疒丷田十
疍	疋旦
赕	贝火火
憺	忄⺈厂八亠二口
膻	⺼亠囗口旦
𫢸	亻丷田十
𬘘	纟冖儿
当	⺌彐
党	龸兄
荡	艹氵𠄎丿丿
挡	扌⺌彐
档	木⺌彐
裆	衤⺌彐
宕	宀石
砀	石𠄎丿丿
珰	𤣩⺌彐
凼	凵水
谠	讠龸兄
垱	土⺌彐
菪	艹宀石
筜	竹⺌彐
𣗋	木龸兄
𬍡	氵𠄎丿丿玉
到	𠫔土刂
倒	亻𠫔土刂
道	辶丷一自
刀	𠃌丿
导	巳寸
岛	{鸟减一}山
盗	冫欠皿
叨	口刀
蹈	𧾷爫臼
祷	礻{寿上丰}寸
捣	扌{鸟减一}山
稻	禾爫臼
悼	忄⺊日十
纛	龶母{具-八}小丿糸
忉	忄刀
氘	气{⿰丿丨}
捯	扌𠫔土刂
鱽	鱼刀
舠	舟刀
的	白勺
地	土也
得	彳旦寸
德	彳十罒一心
嘚	口彳旦寸
锝	钅旦寸
扽	扌屯
等	竹土寸
灯	火丁
登	癶一口䒑
瞪	目癶一口䒑
邓	又⻏
凳	癶一口䒑几
蹬	𧾷癶一口䒑
噔	口癶一口䒑
镫	钅癶一口䒑
磴	石癶一口䒑
戥	日生戈
嶝	山癶一口䒑
璒	𤣩癶一口䒑
第	竹𢎨
弟	丷𢎨
底	广氐
低	亻氐
帝	亠丷冖巾
敌	舌攵
抵	扌氐
递	辶丷𢎨
迪	辶由
滴	氵亠丷冂古
蒂	艹亠丷冖巾
狄	犭火
笛	竹由
嘀	口亠丷冂古
堤	土日一龰
邸	氐⻏
嫡	女亠丷冂古
棣	木隶
缔	纟亠丷冖巾
谛	讠亠丷冖巾
涤	氵夂木
荻	艹犭火
娣	女丷𢎨
诋	讠氐
氐	氏丶
砥	石氐
镝	钅亠丷冂古
睇	目丷𢎨
坻	土氐
柢	木氐
鞮	革日一龰
羝	羊氐
觌	十乛大⺀见
籴	入米
骶	冎⺼氐
碲	石亠丷冖巾
禘	礻亠丷冖巾
翟	习习亻{隹右}
踶	𧾷日一龰
菂	艹白勺
髢	E一厶彡也
玓	𤣩勺
杕	木大
蹢	𧾷亠丷冂古
媂	女亠丷冖巾
提	扌日一龰
䃅	石丷田十
䗖	虫{卅}冖巾
茋	艹氐
𤧛	𤣩亠丷冖巾
𬱖	由页
嗲	口父夕夕
点	占灬
电	由乚
店	广占
殿	尸共殳
典	{曲-一}一八
颠	十{具-八}八页
垫	扌丸土
甸	勹田
惦	忄广占
奠	丷酉大
掂	扌广占
癫	疒十{具-八}八页
巅	山十{具-八}八页
淀	氵宀一龰
滇	氵十{具-八}八
玷	𤣩占
踮	𧾷广占
佃	亻田
靛	龶⺝宀一龰
碘	石{曲-一}一八
钿	钅田
簟	竹覀日十
癜	疒尸共殳
坫	土占
阽	⻖占
扂	户占
琔	𤣩宀一龰
掉	扌⺊日十
调	讠⺆土口
屌	尸口巾
雕	⺆土口亻{隹右}
吊	口巾
钓	钅勺
刁	𠃌㇀
叼	口刁
貂	豸刀口
凋	冫⺆土口
碉	石⺆土口
鲷	鱼⺆土口
铫	钅兆
铞	钅口巾
窎	宀八鸟
汈	氵刁
爹	父夕夕
蝶	虫世木
跌	𧾷丿夫
叠	又又又冖且
碟	石世木
迭	辶丿夫
谍	讠世木
喋	口世木
牒	片世木
堞	土世木
耋	老𠫔土
鲽	鱼世木
昳	日丿夫
蹀	𧾷世木
瓞	瓜丿夫
垤	土𠫔土
绖	纟𠫔土
楪	木世木
𫶇	山{卅}冖巾
定	宀一龰
顶	丁页
丁	一亅
盯	目丁
订	讠丁
叮	口丁
鼎	爿片目
钉	钅丁
锭	钅宀一龰
町	田丁
仃	亻丁
酊	酉丁
腚	⺼宀一龰
玎	𤣩丁
碇	石宀一龰
疔	疒丁
啶	口宀一龰
耵	耳丁
萣	艹宀一龰
丢	丿去
铥	钅丿去
动	云力
东	一𠃋小
洞	氵冂一口
懂	忄艹重
冬	夂⺀
董	艹重
冻	冫东
栋	木东
咚	口冬
峒	山冂一口
胴	⺼冂一口
侗	亻冂一口
恫	忄冂一口
鸫	东鸟
垌	土冂一口
硐	石冂一口
氡	气冬
胨	⺼东
岽	山东
𬟽	虫东
都	耂日⻏
斗	十⺀
抖	扌斗
豆	一口䒑
逗	辶一口䒑
兜	丿𠄌コ白儿
陡	⻖土龰
窦	宀八十乛大⺀
痘	疒一口䒑
蚪	虫斗
蔸	艹丿𠄌コ白儿
篼	竹丿𠄌コ白儿
钭	钅斗
读	讠十乛大⺀
度	广廿又
独	犭虫
毒	龶母
杜	木土
肚	⺼土
赌	贝耂日
督	上小又目
渡	氵广廿又
嘟	口耂日⻏
堵	土耂日
妒	女户
睹	目耂日
笃	竹马
渎	氵十乛大⺀
镀	钅广廿又
犊	牜十乛大⺀
牍	片十乛大⺀
蠹	𰀉冖石虫虫
黩	{里}灬十乛大⺀
阇	门耂日
芏	艹土
椟	木十乛大⺀
髑	冎⺼⺫勹虫
厾	⺄去
𬭊	钅木土
断	𠃊米斤
段	{段-殳}殳
短	矢一口䒑
端	立山而
锻	钅{段-殳}殳
缎	纟{段-殳}殳
煅	火{段-殳}殳
椴	木{段-殳}殳
耑	山而
簖	竹𠃊米斤
塅	土{段-殳}殳
瑖	𤣩{段-殳}殳
对	又寸
队	⻖人
堆	土亻{隹右}
兑	丷兄
怼	又寸心
碓	石亻{隹右}
祋	礻殳
顿	屯页
盾	𠂆十目
蹲	𧾷丷酉寸
敦	亠口子攵
沌	氵屯
遁	辶𠂆十目
吨	口屯
钝	钅屯
墩	土亠口子攵
炖	火屯
盹	目屯
惇	忄亠口子
趸	万足
礅	石亠口子攵
蹾	𧾷亠口子攵
砘	石屯
镦	钅亠口子攵
囤	囗屯
多	夕夕
躲	身𠘧木
朵	𠘧木
夺	大寸
堕	⻖𠂇月土
哆	口夕夕
跺	𧾷𠘧木
踱	𧾷广廿又
舵	舟宀匕
咄	口出
剁	𠘧木刂
铎	钅又𰀁
惰	忄𠂇工月
垛	土𠘧木
掇	扌又又又又
哚	口𠘧木
裰	衤又又又又
埵	土千艹士
饳	饣出
亸	亠口了丷田十
剟	又又又又刂
驮	马大
㙍	土又又又又
饿	饣我
呃	口厂㔾
恶	亚心
额	宀夂口页
俄	亻我
愕	忄口口一丂
鹅	我鸟
噩	王吅口口
娥	女我
厄	厂㔾
峨	山我
鄂	口口一丂⻏
遏	辶曰勹𠃊人
扼	扌厂㔾
鳄	鱼口口一丂
蛾	虫我
婀	女⻖可
讹	讠亻𠤎
锷	钅口口一丂
颚	口口一丂页
鹗	口口一丂鸟
萼	艹口口一丂
屙	尸⻖可
谔	讠口口一丂
垩	亚土
腭	⺼口口一丂
莪	艹我
轭	车厂㔾
苊	艹厂㔾
锇	钅我
崿	山口口一丂
姶	女𠆢一口
涐	氵我
哦	口我
堨	土曰勹𠃊人
𥔲	石口口一丂
𫫇	口亚心
恩	因心
摁	扌因心
蒽	艹因心
而	丆冂丨丨
儿	丿乚
二	一一
尔	⺈小
耳	目一丨
饵	饣耳
迩	辶⺈小
贰	弋二贝
洱	氵耳
珥	𤣩耳
铒	钅耳
鸸	而鸟
陑	⻖而
鲕	鱼而
咡	口耳
耏	而彡
发	{𠃊丿}丶又
法	氵去
罚	罒讠刂
乏	丿之
伐	亻戈
阀	门亻戈
筏	竹亻戈
砝	石去
珐	𤣩去
垡	亻戈土
反	𠂆又
饭	饣𠂆又
翻	釆田习习
烦	火页
凡	几丶
犯	犭㔾
范	艹氵㔾
番	釆田
繁	𠂉母攵糸
返	辶𠂆又
泛	氵乏
帆	巾凡
贩	贝𠂆又
樊	木木乂乂大
藩	艹氵釆田
梵	木木凡
幡	巾釆田
蘩	艹𠂉母攵糸
璠	𤣩釆田
矾	石凡
畈	田𠂆又
燔	火釆田
钒	钅凡
氾	氵㔾
蹯	𧾷釆田
墦	土釆田
𫔍	钅釆田
𬸪	釆田鸟
放	方攵
房	户方
防	⻖方
方	亠丿𠃌
仿	亻方
芳	艹方
访	讠方
妨	女方
坊	土方
纺	纟方
肪	⺼方
舫	舟方
枋	木方
昉	日方
鲂	鱼方
邡	方⻏
钫	钅方
牥	牜方
蚄	虫方
飞	㇈丿丶
非	丨三丨三
费	弗贝
菲	艹非
废	广{𠃊丿}丶又
妃	女己
肥	⺼巴
啡	口非
匪	匚非
沸	氵弗
肺	⺼巿
绯	纟非
斐	非文
霏	雨非
翡	非习习
扉	户非
吠	口犬
诽	讠非
蜚	非虫
狒	犭弗
腓	⺼非
悱	忄非
淝	氵⺼巴
芾	艹巿
痱	疒非
榧	木匚非
鲱	鱼非
篚	竹匚非
朏	月出
棐	非木
镄	钅弗贝
剕	非刂
𬴂	马非
分	八刀
份	亻分
纷	纟分
奋	大田
愤	忄十廾贝
粉	米分
氛	气分
吩	口分
芬	艹分
焚	木木火
坟	土文
忿	分心
粪	米共
汾	氵分
酚	酉分
棼	木木分
偾	亻十廾贝
鲼	鱼十廾贝
棻	艹分木
鼢	臼{鼠下}分
翂	习习分
瀵	氵米田共
坋	土分
豮	豕十廾贝
𣸣	氵十廾贝
风	几乂
封	土土寸
凤	⺇又
峰	山夂丰
疯	疒风
锋	钅夂丰
枫	木风
丰	三丨
奉	𡗗𰀁
冯	冫马
缝	纟辶夂丰
逢	辶夂丰
讽	讠风
蜂	虫夂丰
烽	火夂丰
俸	亻𡗗𰀁
沣	氵丰
沨	氵风
酆	山丰丰一口䒑⻏
葑	艹土土寸
唪	口𡗗𰀁
砜	石风
赗	贝⺜目
浲	氵夂丰
崶	山土土寸
否	不口
缶	𠂉十凵
服	月卩又
夫	二人
父	八乂
复	𠂉日夂
福	礻𠮛田
府	广亻寸
副	𠮛田刂
负	⺈贝
付	亻寸
富	宀𠮛田
妇	女彐
附	⻖亻寸
伏	亻犬
傅	亻甫寸
浮	氵爫子
扶	扌夫
抚	扌无
符	竹亻寸
肤	⺼夫
腹	⺼𠂉日夂
幅	巾𠮛田
咐	口亻寸
覆	覀彳𠂉日夂
腐	广亻寸肉
弗	弓丿丨
赴	土龰卜
斧	父斤
俯	亻广亻寸
赋	贝戈一止
辅	车甫
芙	艹夫
拂	扌弗
甫	十丶用
俘	亻爫子
缚	纟甫寸
蝠	虫𠮛田
敷	甫方攵
脯	⺼甫
袱	衤亻犬
腑	⺼广亻寸
辐	车𠮛田
孚	爫子
驸	马亻寸
釜	父一土丷
苻	艹亻寸
匐	勹𠮛田
宓	宀必
阜	𠂤十
孵	卵爫子
馥	禾日𠂉日夂
茀	艹弗
涪	氵立口
茯	艹亻犬
凫	{鸟减一}几
蚨	虫夫
拊	扌亻寸
蝮	虫𠂉日夂
讣	讠卜
黼	业⺌冂小甫
趺	𧾷夫
怫	忄弗
氟	气弗
蜉	虫爫子
黻	业⺌冂小𠂇丶又
麸	龶夂夫
绂	纟𠂇丶又
跗	𧾷亻寸
鲋	鱼亻寸
罘	罒不
滏	氵父一土丷
郛	爫子⻏
菔	艹月卩又
桴	木爫子
幞	巾业䒑夫
祓	礻𠂇丶又
呋	口夫
绋	纟弗
莩	艹爫子
赙	贝甫寸
鄜	鹿⻏
芣	艹不
洑	氵亻犬
簠	竹甫皿
榑	木甫寸
稃	禾爫子
韨	韦𠂇丶又
玞	𤣩夫
砆	石夫
垺	土爫子
㕮	口父
㳇	氵父
琈	𤣩爫子
𫓧	钅夫
𫖯	兆页
尬	尢介
嘎	口𦣻戈
伽	亻力口
噶	口艹曰勹𠃊人
旮	九日
咖	口力口
尕	乃小
尜	小大小
轧	车乚
钆	钅乚
戛	𦣻戈
该	讠亠{丩}人
改	己攵
盖	𦍌皿
概	木{艮}旡
丐	一⺊㇉
钙	钅丐
溉	氵{艮}旡
赅	贝亠{丩}人
垓	土亠{丩}人
陔	⻖亠{丩}人
戤	乃又皿戈
荄	艹亠{丩}人
晐	日亠{丩}人
𬮿	⻖山己
感	戊{一}口心
干	一十
敢	{⿱𠃍耳}攵
赶	土龰干
甘	廿一
尴	尢丨丨𠂉丶皿
杆	木干
肝	⺼干
竿	竹干
橄	木{⿱𠃍耳}攵
赣	立日十夂工贝
秆	禾干
柑	木甘
擀	扌十十日𠆢干
玕	𤣩干
淦	氵金
泔	氵甘
矸	石干
坩	土甘
绀	纟甘
苷	艹甘
旰	日干
疳	疒甘
酐	酉干
澉	氵{⿱𠃍耳}攵
虷	虫干
鳡	鱼戊{一}口心
㽏	氵𠆢一口甘
刚	冂㐅刂
港	氵共巳
钢	钅冂㐅
岗	山冂㐅
冈	冂㐅
缸	缶工
纲	纟冂㐅
罡	罒正
杠	木工
肛	⺼工
筻	竹更
冮	冫工
矼	石工
堽	土罒正
戆	立日十夂工贝心
扛	扌工
㭎	木冂㐅
鿍	土夂㐄
高	亠口冂口
告	⺧口
搞	扌亠口冂口
糕	米𦍌灬
稿	禾亠口冂口
膏	亠口冂口⺝
羔	𦍌灬
皋	白大十
镐	钅亠口冂口
睾	丿⺫土丷干
篙	竹亠口冂口
诰	讠⺧口
槁	木亠口冂口
杲	日木
缟	纟亠口冂口
锆	钅⺧口
郜	⺧口⻏
藁	艹亠口冂口木
槔	木白大十
筶	竹⺧口
个	𠆢丨
哥	可可
各	夂口
格	木夂口
歌	可可欠
革	廿口十
隔	⻖鬲
阁	门夂口
葛	艹曰勹𠃊人
割	宀丰口刂
胳	⺼夂口
戈	弋丿
搁	扌门夂口
鸽	𠆢一口鸟
疙	疒𠂉乙
骼	冎⺼夂口
嗝	口鬲
硌	石夂口
咯	口夂口
铬	钅夂口
鬲	𠮛𦉰丨
圪	土𠂉乙
蛤	虫𠆢一口
舸	舟可
膈	⺼鬲
虼	虫𠂉乙
袼	衤夂口
哿	力口可
镉	钅鬲
仡	亻𠂉乙
饹	饣夂口
塥	土鬲
滆	氵鬲
合	𠆢一口
给	纟𠆢一口
跟	𧾷艮
根	木艮
亘	一旦
艮	日{𧘇-丿}
哏	口艮
茛	艹艮
更	一由丿乀
耿	耳火
哽	口更
耕	耒井
羹	𦍌灬𦍌大
庚	广⺕人
梗	木更
赓	广⺕人贝
埂	土更
鲠	鱼更
绠	纟更
浭	氵更
暅	日忄一旦
颈	𢀖页
鹒	广⺕人鸟
𬒔	石止⺝
公	八厶
工	一丄
功	工力
攻	工攵
宫	宀口口
共	卄一八
供	亻共
恭	共⺗
弓	𠃍一㇉
贡	工贝
躬	身弓
拱	扌共
龚	龙共
巩	工凡
蚣	虫公
觥	⺈用⺌一儿
汞	工水
肱	⺼𠂇厶
珙	𤣩共
䢼	共⻏
硔	石共
够	句夕夕
狗	犭句
构	木勾
勾	勹厶
购	贝勾
沟	氵勾
钩	钅勾
苟	艹句
垢	土𠂆一口
篝	竹𠀎冉
佝	亻句
媾	女𠀎冉
枸	木句
诟	讠𠂆一口
彀	士冖一弓殳
缑	纟亻ユ矢
遘	辶𠀎冉
鞲	革𠀎冉
笱	竹句
觏	𠀎冉见
岣	山句
姤	女𠂆一口
雊	句亻{隹右}
耇	耂句
句	勹口
古	十口
故	古攵
顾	厂㔾页
股	⺼殳
姑	女古
骨	冎⺼
孤	子瓜
谷	八人口
鼓	士口䒑支
固	囗古
估	亻古
咕	口古
辜	古辛
雇	户亻{隹右}
蛊	虫皿
菇	艹女古
汩	氵曰
箍	竹扌匚巾
锢	钅囗古
沽	氵古
贾	覀贝
鹘	冎⺼鸟
臌	⺼士口䒑支
牯	牜古
轱	车古
鸪	古鸟
梏	木⺧口
痼	疒囗古
钴	钅古
毂	士冖车殳
崮	山囗古
诂	讠古
瞽	士口䒑支目
菰	艹子瓜
蛄	虫古
羖	羊殳
觚	⺈用瓜
嘏	古尸二コ又
罟	罒古
榖	士冖一木殳
酤	酉古
馉	饣冎⺼
牿	牜⺧口
堌	土囗古
蓇	艹冎⺼
鲴	鱼囗古
呱	口瓜
鹄	⺧口鸟
瀔	氵士冖一禾殳
𦙶	⺼古
挂	扌土土
瓜	𠂆厶乀
刮	舌刂
寡	宀𦣻一分
卦	土土卜
褂	衤土土卜
剐	口内刂
鸹	舌鸟
诖	讠土土
栝	木舌
胍	⺼瓜
怪	忄又土
乖	千北
拐	扌口力
掴	扌囗玉
夬	ユ人
关	丷天
管	竹宀㠯
官	宀㠯
观	又见
馆	饣宀㠯
惯	忄毌贝
冠	冖元寸
贯	毌贝
灌	氵艹口口亻{隹右}
罐	缶艹口口亻{隹右}
棺	木宀㠯
倌	亻宀㠯
盥	𦥑水皿
掼	扌毌贝
涫	氵宀㠯
鳏	鱼⺫八小
鹳	艹口口亻{隹右}鸟
瓘	𤣩艹口口亻{隹右}
祼	礻果
琯	𤣩宀㠯
毌	{𠃊𠃌一(母-丶丶)}丨
筦	竹宀元
蒄	艹冖元寸
爟	火艹口口亻{隹右}
纶	纟仑
莞	艹宀元
鳤	鱼竹宀㠯
光	⺌一儿
广	丶厂
逛	辶犭王
咣	口⺌一儿
犷	犭广
胱	⺼⺌一儿
桄	木⺌一儿
洸	氵⺌一儿
珖	𤣩⺌一儿
垙	土⺌一儿
𨐈	车⺌一儿
鬼	丿{鬼-厶}厶
贵	中一贝
规	夫见
归	リ彐
跪	𧾷⺈厂㔾
柜	木巨
诡	讠⺈厂㔾
瑰	𤣩鬼
桂	木土土
龟	⺈电
轨	车九
闺	门土土
圭	土土
桧	木𠆢云
刽	𠆢云刂
癸	癶天
硅	石土土
妫	女为
珪	𤣩土土
皈	白𠂆又
晷	日夂卜口
鲑	鱼土土
刿	山夕刂
鳜	鱼厂屰欠
姽	女⺈厂㔾
簋	竹艮皿
庋	广支
宄	宀九
匦	匚车九
邽	土土⻏
鬶	夫见鬲
炅	日火
筀	竹土土
滚	氵衣公
棍	木日匕匕
衮	衣公
鲧	鱼丿糸
磙	石衣公
辊	车日匕匕
绲	纟日匕匕
过	辶寸
国	囗玉
果	田木
郭	亠口子⻏
锅	钅口内
裹	衣果
蝈	虫囗玉
聒	耳舌
帼	巾囗玉
椁	木亠口子
虢	爫寸虍几
埚	土口内
呙	口内
崞	山亠口子
腘	⺼囗玉
馘	丷一自戈口{一}
粿	米果
蜾	虫果
馃	饣果
涡	氵口内
𬇹	氵囗玉
哈	口𠆢一口
铪	钅𠆢一口
还	辶不
海	氵𠂉母
孩	子亠{丩}人
害	宀丰口
骇	马亠{丩}人
嗨	口氵𠂉母
骸	冎⺼亠{丩}人
亥	亠{丩}人
咳	口亠{丩}人
嗐	口宀丰口
氦	气亠{丩}人
醢	酉𠂇口皿
胲	⺼亠{丩}人
咍	口厶口
汉	氵又
寒	宀𠀎八⺀
喊	口戊{一}口
韩	十十日韦
汗	氵干
含	𠆢一㇇口
涵	氵凵了{水}
翰	十十日𠆢习习
憾	忄戊{一}口心
罕	⺳干
撼	扌戊{一}口心
悍	忄日干
瀚	氵十十日𠆢习习
函	凵了{水}
憨	{⿱𠃍耳}攵心
旱	日干
酣	酉甘
颔	𠆢一㇇口页
邯	甘⻏
捍	扌日干
鼾	自田丌干
晗	日𠆢一㇇口
菡	艹凵了{水}
焊	火日干
顸	干页
邗	干⻏
焓	火𠆢一㇇口
蚶	虫甘
扞	扌干
撖	扌{⿱𠃍耳}攵
暵	日艹中天
浛	氵𠆢一㇇口
琀	𤣩𠆢一㇇口
㘎	口门{⿱𠃍耳}攵
垾	土日干
崡	山凵了{水}
嵅	山戊{一}口
蔊	艹火日干
行	彳一丁
航	舟亠几
杭	木亠几
沆	氵亠几
颃	亠几页
绗	纟彳一丁
吭	口亠几
巷	共巳
好	女子
号	口丂
毫	亠口冖毛
豪	亠口冖豕
浩	氵⺧口
耗	耒毛
昊	日天
郝	赤⻏
嚎	口亠口冖豕
皓	白⺧口
壕	土亠口冖豕
嗥	口白大十
颢	日亠口小页
濠	氵亠口冖豕
蒿	艹亠口冂口
灏	氵日亠口小页
貉	豸夂口
蚝	虫毛
薅	艹女辰寸
皞	白白大十
淏	氵日天
嚆	口艹亠口冂口
鄗	亠口冂口⻏
和	禾口
何	亻可
喝	口曰勹𠃊人
呵	口可
河	氵可
赫	赤赤
核	木亠{丩}人
贺	力口贝
盒	𠆢一口皿
荷	艹亻可
鹤	冖亻{隹右}鸟
禾	丿木
褐	衤曰勹𠃊人
嗬	口艹亻可
壑	⺊𠔼又谷土
阖	门去皿
吓	口下
涸	氵囗古
劾	亠{丩}人力
颌	𠆢一口页
阂	门亠{丩}人
诃	讠可
郃	𠆢一口⻏
纥	纟𠂉乙
龢	𠆢一𠱠冂卄禾
鞨	革曰勹𠃊人
翮	鬲习习
曷	曰勹𠃊人
龁	止凵人𠂉乙
盍	去皿
菏	艹氵可
盉	禾皿
饸	饣𠆢一口
熇	火亠口冂口
鹖	曰勹𠃊人鸟
翯	习习亠口冂口
垎	土夂口
隺	冖亻{隹右}
𬌗	牙𠆢一口
黑	{里}灬
嘿	口{里}灬
𬭶	钅{里}灬
很	彳艮
狠	犭艮
恨	忄艮
痕	疒艮
𬣳	讠艮
哼	口亠口了
横	木黄
衡	彳一丁⺈田大
恒	忄一旦
亨	亠口了
蘅	艹彳一丁⺈田大
珩	𤣩彳一丁
姮	女一旦
桁	木彳一丁
鸻	彳一丁鸟
堼	土土寸土
红	纟工
轰	车又又
洪	氵共
虹	虫工
宏	宀𠂇厶
鸿	氵工鸟
哄	口共
弘	弓厶
烘	火共
泓	氵弓厶
闳	门𠂇厶
讧	讠工
薨	艹罒冖歹匕
訇	勹亠二口
荭	艹纟工
纮	纟𠂇厶
吽	口牛
竑	立𠂇厶
蕻	艹镸共
翃	𠂇厶习习
黉	𰃮黄
唝	口工贝
玒	𤣩工
谼	谷共
𫟹	钅共
𬭎	钅宀𠂇厶
后	𠂆一口
候	亻丨ユ矢
厚	厂曰子
吼	口子乚
侯	亻ユ矢
猴	犭亻ユ矢
喉	口亻ユ矢
逅	辶𠂆一口
篌	竹亻ユ矢
瘊	疒亻ユ矢
鲎	𰃮鱼
堠	土亻ユ矢
垕	𠂆一口土
齁	自田丌句
骺	冎⺼𠂆一口
糇	米亻ユ矢
郈	𠂆一口⻏
鲘	鱼𠂆一口
𬭤	钅亻ユ矢
乎	丿䒑亅
呼	口乎
忽	勿心
护	扌户
胡	古月
虎	虍几
湖	氵古月
糊	米古月
户	丶尸
互	一彑
狐	犭瓜
壶	士冖业
蝴	虫古月
惚	忄勿心
弧	弓瓜
唬	口虍几
葫	艹古月
沪	氵户
扈	户口巴
瑚	𤣩古月
琥	𤣩虍几
浒	氵讠𠂉十
斛	⺈用斗
囫	囗勿
祜	礻古
醐	酉古月
唿	口勿心
猢	犭古月
笏	竹勿
瓠	大一丂瓜
槲	木⺈用斗
怙	忄古
煳	火古月
鹕	古月鸟
滹	氵虍乎
觳	士冖一角殳
岵	山古
烀	火乎
鄠	雨一丂⻏
戽	户斗
縠	士冖一糸殳
冱	冫互
鹱	{鸟减一}一艹亻{隹右}又
淴	氵勿心
昒	日勿
鳠	鱼艹亻{隹右}又
嫭	女虍乎
轷	车乎
昈	日户
话	讠舌
花	艹亻𠤎
化	亻𠤎
华	亻𠤎十
划	戈刂
画	一凵田
滑	氵冎⺼
哗	口亻𠤎十
猾	犭冎⺼
桦	木亻𠤎十
骅	马亻𠤎十
婳	女一凵田
铧	钅亻𠤎十
砉	丰石
觟	⺈用土土
坏	土不
怀	忄不
淮	氵亻{隹右}
槐	木鬼
徊	彳囗口
踝	𧾷果
换	扌⺈{囗-一}大
缓	纟爫一𠂇又
环	𤣩不
幻	幺𠃌
唤	口⺈{囗-一}大
欢	又欠
患	串心
焕	火⺈{囗-一}大
桓	木一旦
鬟	E一厶彡⺫一口𧘇
宦	宀臣
寰	宀⺫一口𧘇
浣	氵宀元
痪	疒⺈{囗-一}大
涣	氵⺈{囗-一}大
奂	⺈{囗-一}大
圜	囗⺫一口𧘇
豢	龹豕
獾	犭艹口口亻{隹右}
洹	氵一旦
嬛	女⺫一口𧘇
缳	纟⺫一口𧘇
萑	艹亻{隹右}
鲩	鱼宀元
郇	勹日⻏
漶	氵串心
逭	辶宀㠯
擐	扌⺫一口𧘇
锾	钅爫一𠂇又
镮	钅⺫一口𧘇
澴	氵⺫一口𧘇
鹮	⺫一口𧘇鸟
貆	豸一旦
峘	山一旦
㬊	日爫一𠂇又
荁	艹一旦
𤩽	𤣩十冂丷干犬
𬘫	纟宀元
黄	卄一由八
皇	白王
晃	日⺌一儿
慌	忄艹亡𫶧
荒	艹亡𫶧
恍	忄⺌一儿
谎	讠艹亡𫶧
惶	忄白王
凰	⺇白王
煌	火白王
簧	竹黄
徨	彳白王
蝗	虫白王
幌	巾日⺌一儿
潢	氵黄
璜	𤣩黄
遑	辶白王
磺	石黄
隍	⻖白王
肓	亡⺝
湟	氵白王
蟥	虫黄
篁	竹白王
鳇	鱼白王
滉	氵日⺌一儿
喤	口白王
癀	疒黄
锽	钅白王
艎	舟白王
瑝	𤣩白王
媓	女白王
㿠	白⺌一儿
𨱑	钅黄
会	𠆢云
回	囗口
挥	扌冖车
灰	𠂇火
慧	丰丰彐心
辉	⺌一儿冖车
恢	忄𠂇火
毁	臼工殳
悔	忄𠂉母
惠	{惠-心}心
汇	氵匚
绘	纟𠆢云
徽	彳山攵丿糸
讳	讠韦
晖	日冖车
晦	日𠂉母
贿	贝𠂇月
秽	禾山夕
卉	十廾
麾	广木木毛
诲	讠𠂉母
蕙	艹{惠-心}心
彗	丰丰彐
诙	讠𠂇火
喙	口彑𧰨
荟	艹𠆢云
烩	火𠆢云
虺	兀虫
蛔	虫囗口
珲	𤣩冖车
咴	口𠂇火
茴	艹囗口
恚	土土心
洄	氵囗口
袆	衤韦
隳	⻖𠂇工月𠆢⺗
翚	习习冖车
翙	山夕习习
浍	氵𠆢云
蟪	虫{惠-心}心
硊	石⺈厂㔾
橞	木{惠-心}心
哕	口山夕
溃	氵中一贝
㧑	扌为
烠	火𠂇月
𬤝	讠{惠-心}心
𬭬	钅丰丰彐
混	氵日匕匕
婚	女氏日
魂	云鬼
昏	氏日
浑	氵冖车
荤	艹冖车
馄	饣日匕匕
诨	讠冖车
阍	门氏日
溷	氵囗豕
惛	忄氏日
碈	石氏日
或	戈口{一}
活	氵舌
火	丷人
伙	亻火
获	艹犭犬
惑	戈口{一}心
货	亻𠤎贝
祸	礻口内
霍	雨亻{隹右}
豁	宀丰口谷
夥	果夕夕
嚯	口雨亻{隹右}
藿	艹雨亻{隹右}
镬	钅艹亻{隹右}又
蠖	虫艹亻{隹右}又
攉	扌雨亻{隹右}
钬	钅火
嚄	口艹亻{隹右}又
锪	钅勿心
劐	艹亻{隹右}又刂
濩	氵艹亻{隹右}又
耠	耒𠆢一口
漷	氵亠口子⻏
㸌	火雨亻{隹右}
佸	亻舌
𬴃	马丰石
级	纟及
集	亻{隹右}木
几	丿㇈
及	丿㇋乀
机	木几
记	讠己
季	禾子
击	𰀁凵
急	⺈彐心
鸡	又鸟
挤	扌齐
系	丿糸
即	{艮}卩
既	{艮}旡
极	木及
计	讠十
激	氵白方攵
继	纟𠃊米
基	卄二一八土
寄	宀大可
忌	己心
己	コ乚
际	⻖示
纪	纟己
技	扌支
济	氵齐
迹	辶亠{亦下}
吉	士口
积	禾只
寂	宀上小又
疾	疒矢
姬	女𦣞
绩	纟龶贝
祭	𱼀龴示
肌	⺼几
辑	车口耳
籍	竹耒卄一日
圾	土及
妓	女支
嫉	女疒矢
饥	饣几
剂	齐刂
奇	大可
脊	人{冫⿱丿丶}⺝
稽	禾尤匕日
叽	口几
唧	口{艮}卩
讥	讠几
藉	艹耒卄一日
冀	北田共
戟	十十日戈
棘	朿朿
缉	纟口耳
悸	忄禾子
羁	罒革马
玑	𤣩几
伎	亻支
霁	雨齐
矶	石几
髻	E一厶彡士口
稷	禾田八夂
岌	山及
汲	氵及
畸	田大可
笈	竹及
觊	山己见
骥	马北田共
嵇	禾尤山
蓟	艹鱼刂
箕	竹卄二一八
佶	亻士口
瘠	疒人{冫⿱丿丶}⺝
畿	戈幺幺田
犄	牜大可
亟	了叹一
跻	𧾷齐
殛	歹亟
暨	{艮}旡旦
鲫	鱼{艮}卩
偈	亻曰勹𠃊人
齑	齐韭
蒺	艹疒矢
芨	艹及
屐	尸彳支
荠	艹齐
楫	木口耳
赍	十人人冖贝
乩	占乚
麂	鹿几
笄	竹开
芰	艹支
墼	車凵殳土
鹡	人{冫⿱丿丶}⺝鸟
剞	大可刂
戢	口耳戈
虮	虫几
伋	亻及
垍	土自
掎	扌大可
洎	氵自
跽	𧾷己心
嵴	山人{冫⿱丿丶}⺝
鲚	鱼齐
蕺	艹口耳戈
罽	罒厂火火刂
蹐	𧾷人{冫⿱丿丶}⺝
姞	女士口
漈	氵𱼀龴示
穄	禾𱼀龴示
耤	耒卄一日
觭	⺈用大可
惎	卄二一八心
期	卄二一八月
鱾	鱼己
㴔	氵⺈彐心
堲	{艮}卩土
徛	彳大可
枅	木开
瀱	氵罒厂火火刂
𪟝	龶贝力
𫌀	衤龶贝
𫓯	钅土土
𫓹	钅卄二一八
𬯀	⻖齐
𬶨	{艮}旡鱼
𬶭	鱼𱼀龴示
家	宀豕
加	力口
价	亻介
假	亻尸二コ又
架	力口木
甲	田丨
佳	亻土土
夹	一䒑人
嘉	士口䒑力口
嫁	女宀豕
驾	力口马
颊	夹页
迦	辶力口
茄	艹力口
稼	禾宀豕
枷	木力口
珈	𤣩力口
袈	力口衣
葭	艹尸二コ又
浃	氵夹
胛	⺼甲
痂	疒力口
笳	竹力口
岬	山甲
槚	木覀贝
钾	钅甲
荚	艹夹
郏	夹⻏
铗	钅夹
跏	𧾷力口
蛱	虫夹
恝	丰刀心
斝	口口冖斗
镓	钅宀豕
瘕	疒尸二コ又
泇	氵力口
𬂩	木夹
见	冂儿
间	门日
剑	佥刂
件	亻牛
建	廴聿
键	钅廴聿
渐	氵车斤
简	竹门日
坚	丨丨又土
肩	户⺝
箭	竹丷一⺝刂
舰	舟见
尖	小大
监	丨丨𠂉丶皿
健	亻廴聿
检	木佥
减	冫戊{一}口
奸	女干
艰	又艮
兼	丷一〢⺕八
鉴	丨丨𠂉丶金
贱	贝戋
捡	扌佥
剪	丷一⺝刂刀
溅	氵贝戋
践	𧾷戋
荐	艹𠂇丨子
歼	歹千
拣	扌𫠣
煎	丷一⺝刂灬
俭	亻佥
涧	氵门日
茧	艹虫
谏	讠柬
柬	十囗丷人
笺	竹戋
缄	纟戊{一}口
戬	亚日戈
锏	钅门日
碱	石戊{一}口
睑	目佥
翦	丷一⺝刂习习
饯	饣戋
蹇	宀𠀎八足
僭	亻兂兂曰
菅	艹宀㠯
毽	毛廴聿
腱	⺼廴聿
謇	宀𠀎八亠二口
蒹	艹兼
戋	戈一
槛	木丨丨𠂉丶皿
鞯	革艹𠂇丨子
笕	竹见
鹣	兼鸟
搛	扌兼
缣	纟兼
鞬	革廴聿
湔	氵丷一⺝刂
裥	衤门日
枧	木见
鲣	鱼丨丨又土
趼	𧾷开
谫	讠丷一⺝刂刀
踺	𧾷廴聿
楗	木廴聿
暕	日柬
牮	亻弋牛
篯	竹钅戋
犍	牜廴聿
鳒	鱼兼
𬣡	讠戋
将	丬夕寸
江	氵工
讲	讠井
降	⻖夂㐄
蒋	艹丬夕寸
奖	丬夕大
僵	亻畺
姜	𦍌女
疆	弓土畺
匠	匚斤
浆	丬夕水
酱	丬夕酉
缰	纟畺
绛	纟夂㐄
桨	丬夕木
犟	弓口虫牛
糨	米弓口虫
豇	豆工
茳	艹氵工
礓	石畺
洚	氵夂㐄
耩	耒𠀎冉
膙	⺼弓口虫
鳉	鱼丬夕寸
弶	弓亠口小
强	弓口虫
叫	口丩
教	耂子攵
交	亠父
脚	⺼去卩
角	⺈用
较	车亠父
娇	女夭{⿰丿丨}
焦	亻{隹右}灬
骄	马夭{⿰丿丨}
轿	车夭{⿰丿丨}
搅	扌𰃮见
狡	犭亠父
郊	亠父⻏
胶	⺼亠父
觉	𰃮见
嚼	口爫⺫艮寸
绞	纟亠父
剿	巛果刂
浇	氵𫠠丿兀
缴	纟白方攵
蛟	虫亠父
椒	木上小又
侥	亻𫠠丿兀
矫	矢夭{⿰丿丨}
饺	饣亠父
蕉	艹亻{隹右}灬
校	木亠父
礁	石亻{隹右}灬
皎	白亠父
窖	宀八⺧口
跤	𧾷亠父
佼	亻亠父
姣	女亠父
酵	酉耂子
鲛	鱼亠父
艽	艹九
湫	氵禾火
醮	酉亻{隹右}灬
铰	钅亠父
峤	山夭{⿰丿丨}
茭	艹亠父
徼	彳攵白方
鹪	亻{隹右}灬鸟
敫	白方攵
噍	口亻{隹右}灬
僬	亻亻{隹右}灬
峧	山亠父
滘	氵⺳工口
燋	火亻{隹右}灬
藠	艹白白白
皦	白白方攵
斠	𠀎冉斗
璬	𤣩白方攵
皭	白爫⺫艮寸
恔	忄亠父
䴔	亠父鸟
漖	氵耂子攵
接	扌立女
解	⺈用刀牛
姐	女且
结	纟士口
界	田介
节	艹𰆊
杰	木灬
街	彳一丁土土
借	亻卄一日
介	𠆢{⿰丿丨}
阶	⻖介
洁	氵士口
戒	戈廾
皆	匕匕白
劫	去力
截	戈十亻{隹右}
捷	扌{十⺕}龰
揭	扌曰勹𠃊人
竭	立曰勹𠃊人
届	尸由
婕	女{十⺕}龰
睫	目{十⺕}龰
诫	讠戈廾
桀	夕㐄木
芥	艹介
桔	木士口
诘	讠士口
颉	士口页
嗟	口⺶工
孑	了㇀
羯	羊曰勹𠃊人
拮	扌士口
秸	禾士口
玠	𤣩介
碣	石曰勹𠃊人
讦	讠干
疥	疒介
喈	口匕匕白
蚧	虫介
疖	疒𰆊
絜	丰刀糸
檞	木⺈用刀牛
劼	士口力
骱	冎⺼介
鲒	鱼士口
褯	衤广廿巾
湝	氵匕匕白
岊	巴山
楷	木匕匕白
㛃	丰刀女
悈	忄戈廾
蜐	虫去力
进	⻌井
今	𠆢一㇇
金	𠆢王丷
紧	丨丨又糸
近	辶斤
尽	尺⺀
仅	亻又
禁	木木示
劲	𢀖力
锦	钅白巾
巾	冂丨
筋	竹⺼力
津	氵聿
晋	亚日
斤	𠂆一丨
谨	讠廿中王
浸	氵⺕冖又
襟	衤木木示
矜	矛𠆢一㇇
瑾	𤣩廿中王
烬	火尺⺀
靳	革斤
噤	口木木示
觐	廿中王见
妗	女𠆢一㇇
缙	纟亚日
堇	廿中王
槿	木廿中王
衿	衤𠆢一㇇
荩	艹尺⺀
馑	饣廿中王
卺	了水一㔾
瑨	𤣩亚日
廑	广廿中王
琎	𤣩⻌井
赆	贝尺⺀
溍	氵亚日
祲	礻⺕冖又
浕	氵尺⺀
墐	土廿中王
殣	歹廿中王
珒	𤣩聿
𬬱	钅斤
经	纟𢀖
惊	忄亠口小
竟	立日儿
静	龶⺝⺈{肀亅}
精	米龶⺝
睛	目龶⺝
警	艹句攵亠二口
京	亠口小
境	土立日儿
景	日亠口小
敬	艹句攵
镜	钅立日儿
晶	日日日
净	冫⺈{肀亅}
径	彳𢀖
竞	立兄
井	廾一
靖	立龶⺝
荆	艹开刂
菁	艹龶⺝
阱	⻖井
兢	十兄十兄
憬	忄日亠口小
婧	女龶⺝
鲸	鱼亠口小
茎	艹𢀖
丼	井丶
旌	方𠂉生
痉	疒𢀖
泾	氵𢀖
迳	辶𢀖
璟	𤣩日亠口小
胫	⺼𢀖
儆	亻艹句攵
靓	龶⺝见
粳	米更
獍	犭立日儿
刭	𢀖刂
腈	⺼龶⺝
肼	⺼井
倞	亻亠口小
璥	𤣩艹句攵
麖	鹿亠口小
鼱	臼{鼠下}龶⺝
猄	犭亠口小
䴖	龶⺝鸟
汫	氵井
竫	立⺈{肀亅}
囧	囗八{囗-一}
炯	火冂口
窘	宀八尹口
迥	辶冂口
颎	匕火页
扃	户冂口
冏	冂八口
坰	土冂口
泂	氵冂口
䌹	⺰冂口
𬳶	马冂口
就	亠口小尤
酒	氵酉
久	⺈乀
九	丿㇈
究	宀八九
救	求攵
旧	丨日
舅	臼田力
纠	纟丩
疚	疒久
揪	扌禾火
咎	夂卜口
鹫	亠口小尤鸟
鸠	九鸟
啾	口禾火
臼	丿丨一𠃍一一
灸	久火
赳	土龰丩
厩	厂{艮}旡
柩	木匚久
玖	𤣩久
韭	非一
阄	门⺈电
僦	亻亠口小尤
鬏	E一厶彡禾火
桕	木臼
氿	氵九
㠇	山亠口小尤
巨	匚コ
举	𭕄一八𰀁
居	尸古
局	尸𠃌口
具	{具-八}八
据	扌尸古
聚	耳又丿{水}
剧	尸古刂
距	𧾷巨
惧	忄{具-八}八
拒	扌巨
俱	亻{具-八}八
矩	矢巨
菊	艹勹米
拘	扌句
沮	氵且
鞠	革勹米
狙	犭且
橘	木矛冂八口
驹	马句
飓	风{具-八}八
锯	钅尸古
咀	口且
踞	𧾷尸古
炬	火巨
掬	扌勹米
遽	辶虍豕
倨	亻尸古
雎	且亻{隹右}
钜	钅巨
踽	𧾷禹
裾	衤尸古
琚	𤣩尸古
疽	疒且
莒	艹口口
車	十田十
龃	止凵人且
苣	艹巨
榉	木𭕄一八𰀁
讵	讠巨
苴	艹且
鞫	革勹亠二口
焗	火尸𠃌口
椐	木尸古
锔	钅尸𠃌口
筥	竹口口
屦	尸彳米女
窭	宀八米女
醵	酉虍豕
蒟	艹立句
犋	牜{具-八}八
澽	氵虍豕
娵	女耳又
秬	禾巨
崌	山尸古
岠	山巨
砠	石且
腒	⺼尸古
弆	去廾
泃	氵句
岨	山且
趄	土龰且
䴗	目犬鸟
𬶋	鱼句
卷	龹㔾
娟	女口⺝
倦	亻龹㔾
捐	扌口⺝
眷	龹目
绢	纟口⺝
鹃	口⺝鸟
涓	氵口⺝
圈	囗龹㔾
隽	亻{隹右}乃
镌	钅亻{隹右}乃
蠲	丷一八皿⺫勹虫
狷	犭口⺝
鄄	覀土⻏
锩	钅龹㔾
桊	龹木
焆	火口⺝
绝	纟⺈巴
决	冫夬
爵	爫⺫艮寸
诀	讠夬
掘	扌尸出
厥	厂屰欠
倔	亻尸出
撅	扌厂屰欠
珏	𤣩玉
崛	山尸出
抉	扌夬
噘	口厂屰欠
攫	扌目目亻{隹右}又
谲	讠矛冂八口
獗	犭厂屰欠
蹶	𧾷厂屰欠
傕	亻冖亻{隹右}
蕨	艹厂屰欠
矍	目目亻{隹右}又
橛	木厂屰欠
镢	钅厂屰欠
玦	𤣩夬
孓	了乀
桷	木⺈用
觖	⺈用夬
爝	火爫⺫艮寸
劂	厂屰欠刂
玃	犭目目亻{隹右}又
砄	石夬
㵐	氵厂屰欠
𫔎	钅矛冂八口
𫘝	马夬
均	土匀
君	尹口
军	冖车
俊	亻允夂
郡	尹口⻏
峻	山允夂
钧	钅匀
骏	马允夂
菌	艹囗禾
竣	立允夂
浚	氵允夂
珺	𤣩尹口
麇	鹿禾
皲	冖车皮
焌	火允夂
葰	艹亻允夂
捃	扌尹口
畯	田允夂
莙	艹尹口
晙	日允夂
筠	竹土匀
鲪	鱼尹口
䐃	⺼囗禾
卡	上卜
喀	口宀夂口
咔	口上卜
胩	⺼上卜
开	一廾
凯	山己几
慨	忄{艮}旡
铠	钅山己
恺	忄山己
揩	扌匕匕白
锴	钅匕匕白
忾	忄气
闿	门山己
剀	山己刂
垲	土山己
锎	钅门开
炌	火介
蒈	艹匕匕白
看	龵目
堪	土卄二匸八
砍	石欠
刊	干刂
侃	亻口𫶧
坎	土欠
勘	卄二匸八力
阚	门{⿱𠃍耳}攵
瞰	目{⿱𠃍耳}攵
龛	𠆢一口龙
戡	卄二匸八戈
崁	山土欠
莰	艹土欠
衎	彳一丁干
磡	石卄二匸八力
嵁	山卄二匸八
墈	土卄二匸八力
抗	扌亠几
康	广隶
亢	亠几
炕	火亠几
慷	忄广隶
糠	米广隶
伉	亻亠几
钪	钅亠几
闶	门亠几
𡐓	土广隶
𩾌	鱼广隶
靠	⺧口非
考	耂丂
烤	火耂丂
铐	钅耂丂
拷	扌耂丂
犒	牜亠口冂口
尻	尸九
栲	木耂丂
㸆	火⺧口非
洘	氵耂丂
可	丁口
刻	亠{丩}人刂
克	十兄
客	宀夂口
科	禾斗
课	讠果
颗	果页
渴	氵曰勹𠃊人
柯	木可
棵	木果
壳	士冖几
氪	气十兄
磕	石去皿
嗑	口去皿
珂	𤣩可
苛	艹可
轲	车可
瞌	目去皿
坷	土可
恪	忄夂口
蝌	虫禾斗
颏	亠{丩}人页
窠	宀八果
稞	禾果
溘	氵去皿
疴	疒可
岢	山可
锞	钅果
髁	冎⺼果
骒	马果
缂	纟革
牁	爿可
匼	匚𠆢一口
炣	火可
剋	十兄刂
肯	止⺝
恳	艮心
啃	口止⺝
垦	艮土
裉	衤艮
坑	土亠几
铿	钅丨丨又土
硁	石𢀖
空	宀八工
恐	工凡心
控	扌宀八工
孔	子乚
崆	山宀八工
箜	竹宀八工
倥	亻宀八工
硿	石宀八工
埪	土宀八工
口	丨𠃍一
扣	扌口
寇	宀元⺊又
叩	口卩
抠	扌区
蔻	艹宀元⺊又
芤	艹子乚
筘	竹扌口
眍	目区
𫸩	弓区
苦	艹古
哭	口口犬
酷	酉⺧口
库	广车
裤	衤广车
枯	木古
骷	冎⺼古
窟	宀八尸出
绔	纟大一丂
喾	𰃮⺧口
刳	大一丂刂
矻	石𠂉乙
圐	囗罒方
夸	大一丂
跨	𧾷大一丂
垮	土大一丂
胯	⺼大一丂
挎	扌大一丂
侉	亻大一丂
姱	女大一丂
快	忄夬
块	土夬
筷	竹忄夬
蒯	艹月月刂
哙	口𠆢云
侩	亻𠆢云
脍	⺼𠆢云
狯	犭𠆢云
郐	𠆢云⻏
鲙	鱼𠆢云
㧟	扌氵匚
宽	宀艹见
款	士示欠
髋	冎⺼宀艹见
况	冫兄
狂	犭王
矿	石广
旷	日广
眶	目匚王
框	木匚王
匡	匚王
筐	竹匚王
哐	口匚王
邝	广⻏
诳	讠犭王
诓	讠匚王
圹	土广
纩	纟广
贶	贝兄
夼	大川
洭	氵匚王
𫛭	犭王鸟
亏	一丂
愧	忄鬼
盔	𠂇火皿
魁	鬼斗
窥	宀八夫见
奎	大土土
葵	艹癶天
傀	亻鬼
睽	目癶天
馈	饣中一贝
逵	辶土儿土
馗	九丷一自
匮	匚中一贝
喟	口田⺝
夔	丷頁止巳夂
篑	竹中一贝
岿	山リ彐
揆	扌癶天
聩	耳中一贝
跬	𧾷土土
愦	忄中一贝
悝	忄里
蝰	虫大土土
暌	日癶天
蒉	艹中一贝
櫆	木鬼斗
骙	马癶天
喹	口大土土
煃	火大土土
戣	癶天戈
𫠆	支页
困	囗木
昆	日匕匕
坤	土申
捆	扌囗木
鲲	鱼日匕匕
琨	𤣩日匕匕
锟	钅日匕匕
髡	E一厶彡兀
阃	门囗木
悃	忄囗木
堃	方方土
焜	火日匕匕
壸	士冖一业
鹍	日匕匕鸟
裈	衤冖车
醌	酉日匕匕
婫	女日匕匕
括	扌舌
扩	扌广
阔	门氵舌
廓	广亠口子⻏
蛞	虫舌
啦	口扌立
拉	扌立
辣	辛束
垃	土立
腊	⺼卄一日
喇	口束刂
蜡	虫卄一日
落	艹氵夂口
剌	束刂
邋	辶巛龱{鼠下}
旯	日九
瘌	疒束刂
砬	石立
镴	钅巛龱{鼠下}
蝲	虫束刂
鞡	革扌立
𬶟	鱼束刂
来	一丷木
莱	艹来
赖	束⺈贝
籁	竹束⺈贝
睐	目来
癞	疒束⺈贝
濑	氵束⺈贝
徕	彳来
崃	山来
涞	氵来
赉	来贝
俫	亻来
铼	钅来
梾	木来
蓝	艹丨丨𠂉丶皿
烂	火兰
懒	忄束⺈贝
拦	扌兰
篮	竹丨丨𠂉丶皿
岚	山风
兰	丷三
栏	木兰
览	丨丨𠂉丶见
澜	氵门柬
揽	扌丨丨𠂉丶见
滥	氵丨丨𠂉丶皿
婪	木木女
阑	门柬
榄	木丨丨𠂉丶见
斓	文门柬
缆	纟丨丨𠂉丶见
褴	衤丨丨𠂉丶皿
谰	讠门柬
罱	罒十冂丷干
襕	衤门柬
镧	钅门柬
漤	氵木木女
𬒗	石丨丨𠂉丶见
狼	犭良
浪	氵良
郎	良⻏
朗	良月
廊	广良⻏
螂	虫良⻏
琅	𤣩良
啷	口良⻏
榔	木良⻏
锒	钅良
阆	门良
烺	火良
蒗	艹氵良
莨	艹良
稂	禾良
崀	山良
㫰	日良
㮾	良月木
埌	土良
塱	良月土
桹	木良
筤	竹良
蓢	艹良月
老	耂匕
劳	艹冖力
牢	宀牛
姥	女老
捞	扌艹冖力
唠	口艹冖力
佬	亻老
烙	火夂口
酪	酉夂口
涝	氵艹冖力
崂	山艹冖力
嫪	女习习𠆢彡
痨	疒艹冖力
醪	酉习习𠆢彡
栳	木老
铑	钅老
耢	耒艹冖力
荖	艹老
铹	钅艹冖力
络	纟夂口
𫭼	土艹冖力
了	乛亅
乐	丿𠃊小
勒	革力
叻	口力
泐	氵⻖力
鳓	鱼革力
仂	亻力
簕	竹革力
嘞	口革力
雷	雨田
类	米大
泪	氵目
累	田糸
蕾	艹雨田
磊	石石石
垒	厶厶厶土
擂	扌雨田
肋	⺼力
儡	亻田田田
镭	钅雨田
羸	亡口月凡羊
檑	木雨田
耒	丰人
诔	讠耒
嫘	女田糸
酹	酉爫寸
缧	纟田糸
礌	石雨田
罍	田田田缶
藟	艹田田田
癗	疒雨田
冷	冫𠆢丶龴
愣	忄罒方
楞	木罒方
棱	木土儿夂
塄	土罒方
崚	山土儿夂
堎	土土儿夂
里	田土
力	𠃌丿
理	𤣩里
李	木子
立	亠䒑
离	亠凶禸
利	禾刂
梨	禾刂木
丽	一冂丶冂丶
历	厂力
礼	礻乚
厉	厂万
例	亻歹刂
莉	艹禾刂
黎	禾㇉丿人氺
璃	𤣩亠凶禸
励	厂万力
哩	口里
狸	犭里
粒	米立
隶	肀水
吏	古丿乀
栗	覀木
漓	氵亠凶禸
雳	雨厂力
厘	厂里
俐	亻禾刂
笠	竹立
沥	氵厂力
篱	竹亠凶禸
戾	户犬
鲤	鱼里
犁	禾刂牛
砾	石乐
荔	艹力力力
砺	石厂万
郦	丽⻏
藜	艹禾㇉丿人氺
骊	马一冂丶冂丶
俪	亻一冂丶冂丶
鹂	丽鸟
蠡	彑𧰨虫虫
栎	木乐
唳	口户犬
喱	口厂里
罹	罒忄亻{隹右}
痢	疒禾刂
莅	艹亻立
俚	亻里
逦	⻌一冂丶冂丶
呖	口厂力
蛎	虫厂万
猁	犭禾刂
澧	氵曲一口䒑
醴	酉曲一口䒑
娌	女里
蓠	艹亠凶禸
詈	⺫亠二口
黧	禾㇉丿{里}灬
蜊	虫禾刂
缡	纟亠凶禸
傈	亻覀木
枥	木厂力
溧	氵覀木
坜	土厂力
疠	疒万
粝	米厂万
嫠	未攵厂女
锂	钅里
篥	竹覀木
轹	车乐
鲡	鱼一冂丶冂丶
疬	疒厂力
苈	艹厂力
浬	氵里
跞	𧾷乐
浰	氵禾刂
鳢	鱼曲一口䒑
醨	酉亠凶禸
凓	冫覀木
朸	木力
㰀	木禾㇉丿人氺
珕	𤣩力力力
𫵷	山厂力
𬍛	𤣩乐
俩	亻两
连	⻌车
脸	⺼佥
联	耳丷天
练	纟𫠣
恋	亠{亦下}心
怜	忄𠆢丶龴
炼	火𫠣
莲	艹⻌车
链	钅⻌车
帘	宀八巾
廉	广兼
敛	佥攵
涟	氵⻌车
镰	钅广兼
琏	𤣩⻌车
濂	氵广兼
潋	氵佥攵
殓	歹佥
奁	大区
裢	衤⻌车
楝	木柬
裣	衤佥
鲢	鱼⻌车
梿	木⻌车
蠊	虫广兼
蔹	艹佥攵
瑓	𤣩柬
𬶠	鱼柬
两	一冂人人
量	日一里
亮	亠口冖几
良	丶艮
凉	冫亠口小
梁	氵刃丶木
辆	车两
粮	米良
谅	讠亠口小
踉	𧾷良
晾	日亠口小
粱	氵刃丶米
魉	鬼两
椋	木亠口小
辌	车亠口小
墚	土氵刃丶木
悢	忄良
俍	亻良
𫟅	纟亠口小
𬜯	艹两
聊	耳𠂎卩
料	米斗
疗	疒了
辽	辶了
廖	广习习𠆢彡
撩	扌大丷日小
寥	宀习习𠆢彡
僚	亻大丷日小
缭	纟大丷日小
燎	火大丷日小
撂	扌田夂口
獠	犭大丷日小
潦	氵大丷日小
镣	钅大丷日小
嘹	口大丷日小
瞭	目大丷日小
寮	宀大丷日小
蓼	艹习习𠆢彡
尥	尢勺
鹩	大丷日小鸟
嫽	女大丷日小
髎	冎⺼习习𠆢彡
钌	钅了
蹽	𧾷大丷日小
漻	氵习习𠆢彡
憭	忄大丷日小
簝	竹大丷日小
橑	木大丷日小
𪤗	土习习𠆢彡
列	歹刂
裂	歹刂衣
猎	犭卄一日
咧	口歹刂
烈	歹刂灬
劣	少力
冽	冫歹刂
趔	土龰歹刂
洌	氵歹刂
鬣	E一厶彡巛龱{鼠下}
捩	扌户犬
埒	土爫寸
躐	𧾷巛龱{鼠下}
峛	山歹刂
脟	⺼爫寸
䴕	歹刂鸟
𫚭	鱼巛龱{鼠下}
林	木木
临	〢𠂉丶𫩏
琳	𤣩木木
淋	氵木木
邻	𠆢丶龴⻏
麟	鹿米夕㐄
凛	冫亠囗口示
拎	扌𠆢丶龴
霖	雨木木
鳞	鱼米夕㐄
吝	文口
躏	𧾷艹门亻{隹右}
粼	米夕㐄巜
磷	石米夕㐄
嶙	山米夕㐄
蔺	艹门亻{隹右}
赁	亻丿士贝
懔	忄亠囗口示
辚	车米夕㐄
遴	辶米夕㐄
廪	广亠囗口示
潾	氵米夕㐄
檩	木亠囗口示
璘	𤣩米夕㐄
啉	口木木
瞵	目米夕㐄
膦	⺼米夕㐄
翷	米夕㐄习习
箖	竹木木
𬭸	钅米夕㐄
𬴊	马米夕㐄
令	𠆢丶龴
灵	彐火
领	𠆢丶龴页
另	口力
凌	冫土儿夂
玲	𤣩𠆢丶龴
零	雨𠆢丶龴
龄	止凵人𠆢丶龴
铃	钅𠆢丶龴
陵	⻖土儿夂
岭	山𠆢丶龴
菱	艹土儿夂
伶	亻𠆢丶龴
聆	耳𠆢丶龴
翎	𠆢丶龴习习
绫	纟土儿夂
〇	〇
羚	羊𠆢丶龴
呤	口𠆢丶龴
苓	艹𠆢丶龴
泠	氵𠆢丶龴
棂	木彐火
瓴	𠆢丶龴瓦
酃	雨口口口⻏
囹	囗𠆢丶龴
鲮	鱼土儿夂
蛉	虫𠆢丶龴
鸰	𠆢丶龴鸟
柃	木𠆢丶龴
舲	舟𠆢丶龴
澪	氵雨𠆢丶龴
昤	日𠆢丶龴
祾	礻土儿夂
姈	女𠆢丶龴
㥄	忄土儿夂
坽	土𠆢丶龴
流	氵厶一𫶧
刘	文刂
留	{丿𠄌丶}刀田
六	亠八
柳	木𠂎卩
溜	氵{丿𠄌丶}刀田
琉	𤣩厶一𫶧
榴	木{丿𠄌丶}刀田
浏	氵文刂
瘤	疒{丿𠄌丶}刀田
硫	石厶一𫶧
遛	辶{丿𠄌丶}刀田
陆	⻖击
绺	纟夂卜口
鎏	氵厶一𫶧金
馏	饣{丿𠄌丶}刀田
骝	马{丿𠄌丶}刀田
镏	钅{丿𠄌丶}刀田
旒	方𠂉厶一𫶧
镠	钅习习𠆢彡
锍	钅厶一𫶧
熘	火{丿𠄌丶}刀田
鹨	习习𠆢彡鸟
飗	风{丿𠄌丶}刀田
瑬	氵厶一𫶧玉
珋	𤣩𠂎卩
罶	罒{丿𠄌丶}刀田
鹠	{丿𠄌丶}刀田鸟
疁	田习习𠆢彡
碌	石彐⺢
龙	尤丿
隆	⻖夂一生
笼	竹龙
拢	扌龙
胧	⺼龙
珑	𤣩龙
咙	口龙
聋	龙耳
垄	龙土
窿	宀八⻖夂一生
陇	⻖龙
泷	氵龙
茏	艹龙
眬	目龙
栊	木龙
砻	龙石
哢	口王廾
昽	日龙
癃	疒⻖夂一生
漋	氵⻖夂一生
弄	王廾
𬕂	竹工贝
楼	木米女
搂	扌米女
漏	氵尸雨
髅	冎⺼米女
露	雨𧾷夂口
陋	⻖𠃊一内
喽	口米女
娄	米女
篓	竹米女
镂	钅米女
偻	亻米女
蝼	虫米女
耧	耒米女
蒌	艹米女
瘘	疒米女
嵝	山米女
溇	氵米女
䁖	目米女
剅	豆刂
𦝼	⺼米女
𪣻	土米女
路	𧾷夂口
鲁	鱼日
录	彐⺢
撸	扌鱼日
卢	⺊尸
鹿	广〢コ匕匕
炉	火户
芦	艹户
禄	礻彐⺢
虏	虍力
璐	𤣩𧾷夂口
噜	口鱼日
戮	习习𠆢彡戈
颅	⺊尸页
庐	广户
漉	氵鹿
掳	扌虍力
辘	车鹿
赂	贝夂口
麓	木木鹿
卤	⺊口㐅
鹭	𧾷夂口鸟
泸	氵⺊尸
潞	氵𧾷夂口
橹	木鱼日
辂	车夂口
箓	竹彐⺢
胪	⺼⺊尸
鲈	鱼⺊尸
轳	车⺊尸
垆	土⺊尸
渌	氵彐⺢
逯	辶彐⺢
鸬	⺊尸鸟
甪	丿用
蕗	艹𧾷夂口
舻	舟⺊尸
栌	木⺊尸
簏	竹鹿
菉	艹彐⺢
氇	毛鱼日
僇	亻习习𠆢彡
琭	𤣩彐⺢
镥	钅鱼日
勠	习习𠆢彡力
稑	禾土儿土
绿	纟彐⺢
澛	氵鱼日
𫘧	马彐⺢
𬬻	钅⺊尸
乱	舌乚
卵	𠂎丶卩丶
鸾	亠丿丨丨丶鸟
峦	亠{亦下}山
挛	亠{亦下}手
銮	亠{亦下}金
孪	亠{亦下}子
栾	亠{亦下}木
滦	氵亠{亦下}木
脔	亠{亦下}肉
娈	亠{亦下}女
论	讠仑
伦	亻仑
轮	车仑
仑	𠆢匕
沦	氵仑
抡	扌仑
囵	囗仑
𫭢	土仑
𬬭	钅仑
罗	罒夕
洛	氵夂口
裸	衤果
逻	⻌罒夕
骆	马夂口
萝	艹⺫夕
螺	虫田糸
锣	钅罒夕
啰	口罒夕
珞	𤣩夂口
骡	马田糸
摞	扌田糸
雒	夂口亻{隹右}
荦	艹冖牛
箩	竹罒夕
椤	木罒夕
猡	犭罒夕
蠃	亡口月凡虫
脶	⺼口内
漯	氵田糸
倮	亻果
捋	扌爫寸
瘰	疒田糸
泺	氵乐
蓏	艹瓜瓜
律	彳聿
率	亠幺冫丿丶十
旅	方𠂉{𧘇}
吕	口口
缕	纟米女
侣	亻口口
驴	马户
屡	尸米女
履	尸彳𠂉日夂
滤	氵虍心
虑	虍心
褛	衤米女
铝	钅口口
闾	门口口
榈	木门口口
氯	气彐⺢
膂	方𠂉{𧘇}⺝
稆	禾口口
葎	艹彳聿
垏	土聿
梠	木口口
略	田夂口
掠	扌亠口小
锊	钅爫寸
䂮	丰刀石
圙	囗八面
吗	口马
马	𠃌㇉一
妈	女马
麻	广木木
嘛	口广木木
骂	口口马
码	石马
玛	𤣩马
抹	扌末
蚂	虫马
蟆	虫艹日大
犸	犭马
杩	木马
祃	礻马
摩	广木木手
买	乛大⺀
卖	十乛大⺀
埋	土里
脉	⺼永
麦	龶夂
迈	⻌万
霾	雨豸里
劢	万力
唛	口龶夂
荬	艹乛大⺀
鿏	钅龶夂
满	氵艹两
慢	忄⺜⺫又
漫	氵⺜⺫又
曼	⺜⺫又
蛮	亠{亦下}虫
瞒	目艹两
蔓	艹⺜⺫又
馒	饣⺜⺫又
幔	巾⺜⺫又
谩	讠⺜⺫又
鳗	鱼⺜⺫又
缦	纟⺜⺫又
嫚	女⺜⺫又
墁	土⺜⺫又
颟	艹两页
螨	虫艹两
鞔	革⺈𫩏儿
镘	钅⺜⺫又
鬘	E一厶彡⺜⺫又
𬜬	艹门口
忙	忄亡
芒	艹亡
茫	艹氵亡
氓	亡民
莽	艹犬廾
盲	亡目
蟒	虫艹犬廾
邙	亡⻏
漭	氵艹犬廾
牤	牜亡
硭	石艹亡
尨	龙丿丿
牻	牜龙丿丿
厖	厂龙丿丿
杧	木亡
毛	丿一一乚
冒	⺜目
貌	豸白儿
猫	犭艹田
矛	予丿
帽	巾⺜目
贸	{丿𠄌丶}刀贝
茂	艹戊
茅	艹矛
冇	𠂇冂
髦	E一厶彡毛
卯	𠂎卩
锚	钅艹田
袤	衣矛
瑁	𤣩⺜目
懋	木矛木心
牦	牜毛
铆	钅𠂎卩
昴	日𠂎卩
耄	老毛
蟊	矛虫虫
峁	山𠂎卩
旄	方𠂉毛
楙	木矛木
泖	氵𠂎卩
瞀	矛攵目
茆	艹𠂎卩
蝥	矛攵虫
芼	艹毛
眊	目毛
鄚	艹日大⻏
么	丿厶
没	氵殳
美	𦍌大
每	𠂉母
妹	女未
眉	𠃜目
梅	木𠂉母
媚	女𠃜目
魅	鬼未
玫	𤣩攵
枚	木攵
媒	女甘木
霉	雨𠂉母
昧	日未
煤	火甘木
寐	宀爿未
嵋	山𠃜目
莓	艹𠂉母
湄	氵𠃜目
袂	衤夬
楣	木𠃜目
酶	酉𠂉母
镁	钅𦍌大
郿	𠃜目⻏
浼	氵⺈𫩏儿
鹛	𠃜目鸟
镅	钅𠃜目
渼	氵𦍌大
糜	广木木米
媄	女𦍌大
瑂	𤣩𠃜目
们	亻门
门	丶丨𠃌
闷	门心
懑	氵艹两心
扪	扌门
焖	火门心
钔	钅门
呇	水口
𫞩	𤣩艹两
梦	木木夕
猛	犭子皿
蒙	艹冖一豕
孟	子皿
盟	日月皿
朦	月艹冖一豕
萌	艹日月
懵	忄艹罒冖目
檬	木艹冖一豕
蜢	虫子皿
勐	子皿力
虻	虫亡
艨	舟艹冖一豕
锰	钅子皿
幪	巾艹冖一豕
艋	舟子皿
蠓	虫艹冖一豕
瞢	艹罒冖目
甍	艹罒冖瓦
獴	犭艹冖一豕
礞	石艹冖一豕
㠓	山艹冖一豕
鹲	艹冖一豕鸟
𫑡	口电⻏
密	宀必山
米	丷木
迷	辶米
弥	弓⺈小
蜜	宀必虫
眯	目米
咪	口米
谜	讠辶米
觅	爫见
靡	广木木非
谧	讠必皿
祢	礻⺈小
芈	卝𰀁
麋	鹿米
弭	弓耳
汨	氵日
猕	犭弓⺈小
幂	冖日大巾
縻	广木木糸
蘼	艹广木木非
醚	酉辶米
祕	礻必
敉	米攵
嘧	口宀必山
蓂	艹冖日六
脒	⺼米
洣	氵米
醾	酉广木木米
面	丆囗{丨丨二}
免	⺈𫩏儿
勉	⺈𫩏儿力
绵	纟白巾
眠	目民
棉	木白巾
缅	纟面
冕	⺜⺈𫩏儿
腼	⺼面
娩	女⺈𫩏儿
湎	氵面
沔	氵丏
渑	氵口电
眄	目丏
丏	丐丨
勔	面力
愐	忄面
偭	亻面
𩾃	鱼⺈𫩏儿
妙	女少
秒	禾少
描	扌艹田
苗	艹田
庙	广由
渺	氵目少
瞄	目艹田
淼	水水水
喵	口艹田
缈	纟目少
藐	艹豸白儿
邈	辶豸白儿
眇	目少
杪	木少
鹋	艹田鸟
缪	纟习习𠆢彡
灭	一火
蔑	艹⺫戊丶
乜	𠃌乚
咩	口羊
篾	竹⺫戊丶
民	𠃍一亅一乚
敏	𠂉母攵
抿	扌民
悯	忄门文
闵	门文
珉	𤣩民
泯	氵民
闽	门虫
皿	冂丨丨一
岷	山民
旻	日文
缗	纟民日
愍	民攵心
湣	氵民日
黾	口电
忞	文心
鳘	𠂉母攵鱼
苠	艹民
明	日月
名	夕口
命	𠆢一口卩
鸣	口鸟
冥	冖日六
铭	钅夕口
茗	艹夕口
瞑	目冖日六
溟	氵冖日六
酩	酉夕口
暝	日冖日六
螟	虫冖日六
洺	氵夕口
谬	讠习习𠆢彡
魔	广木木鬼
莫	艹日大
默	{里}灬犬
模	木艹日大
摸	扌艹日大
磨	广木木石
末	一木
漠	氵艹日大
墨	{里}灬土
麽	广木木么
陌	⻖百
寞	宀艹日大
蓦	艹日大马
沫	氵末
膜	⺼艹日大
茉	艹末
嬷	女广木木么
蘑	艹广木木石
摹	艹日大手
馍	饣艹日大
谟	讠艹日大
嫫	女艹日大
秣	禾末
殁	歹殳
貊	豸百
靺	革末
貘	豸艹日大
镆	钅艹日大
瘼	疒艹日大
耱	耒广木木石
万	丆𠃌
无	一尢
藦	艹广木木手
𬙊	纟{里}灬土
某	甘木
谋	讠甘木
眸	目厶牛
牟	厶牛
哞	口厶牛
鍪	矛攵金
侔	亻厶牛
蛑	虫厶牛
目	囗二
母	{𠃊𠃌一(母-丶丶)}丶丶
木	十人
慕	艹日大⺗
幕	艹日大巾
姆	女母
穆	禾白小彡
牧	牜攵
墓	艹日大土
沐	氵木
暮	艹日大日
拇	扌母
牡	牜土
亩	亠田
募	艹日大力
睦	目土儿土
苜	艹目
呒	口无
钼	钅目
毪	毛厶牛
仫	亻么
𧿹	𧾷母
𬭁	钅母
那	𭃂⻏
哪	口𭃂⻏
拿	𠆢一口手
娜	女𭃂⻏
纳	纟内
呐	口内
捺	扌大示
衲	衤内
钠	钅内
肭	⺼内
镎	钅𠆢一口手
乸	也母
南	十冂丷干
𦰡	艹𭃂⻏
奶	女乃
奈	大示
耐	而寸
乃	𠄎丿
鼐	乃爿片目
氖	气乃
萘	艹大示
艿	艹乃
柰	木示
佴	亻耳
迺	辶西
难	又亻{隹右}
男	田力
喃	口十冂丷干
楠	木十冂丷干
囡	囗女
赧	赤卩又
腩	⺼十冂丷干
蝻	虫十冂丷干
萳	艹十冂丷干
婻	女十冂丷干
囊	𰀉冖吅𠀎𧘇
囔	口𰀉冖吅𠀎𧘇
馕	饣𰀉冖吅𠀎𧘇
攮	扌𰀉冖吅𠀎𧘇
曩	日襄
齉	自田丌𰀉冖吅𠀎𧘇
脑	⺼亠凶
闹	门亠巾
恼	忄亠凶
挠	扌𫠠丿兀
瑙	𤣩巛丿囗㐅
孬	不女子
呶	口女又
淖	氵⺊日十
猱	犭矛木
铙	钅𫠠丿兀
垴	土亠凶
蛲	虫𫠠丿兀
硇	石丿囗㐅
臑	⺼雨而
峱	犭丑山
呢	口尸匕
讷	讠内
内	冂人
馁	饣爫女
嫩	女束攵
恁	亻丿士心
能	厶⺝匕匕
你	亻⺈小
尼	尸匕
妮	女尸匕
泥	氵尸匕
逆	辶屰
拟	扌𠄌丶人
腻	⺼弋二贝
倪	亻臼儿
霓	雨臼儿
匿	匚艹𠂇口
溺	氵𢎥𢎥
昵	日尸匕
睨	目臼儿
旎	方𠂉尸匕
怩	忄尸匕
猊	犭臼儿
鲵	鱼臼儿
伲	亻尸匕
坭	土尸匕
铌	钅尸匕
麑	鹿臼儿
薿	艹匕矢龴疋
𨺙	⻖臼儿
𫐐	车臼儿
𫠜	止凵人臼儿
年	𠂉㐄
念	𠆢一㇇心
黏	禾人氺占
拈	扌占
捻	扌𠆢一㇇心
碾	石尸卄一{𧘇-丿}
撵	扌夫夫车
蔫	艹正㇉一灬
廿	艹一
辇	夫夫车
鲇	鱼占
鲶	鱼𠆢一㇇心
埝	土𠆢一㇇心
粘	米占
娘	女良
酿	酉良
鸟	{鸟减一}一
尿	尸水
袅	{鸟减一}衣
茑	艹鸟
脲	⺼尸水
捏	扌日土
聂	耳又又
孽	艹𠂤辛子
涅	氵日土
蹑	𧾷耳又又
嗫	口耳又又
啮	口止凵人
臬	自木
镊	钅耳又又
镍	钅自木
蘖	艹𠂤辛木
颞	耳又又页
糵	艹𠂤辛米
陧	⻖日土
嵲	山自木
菍	艹𠆢一㇇心
𫔶	门自木
您	亻⺈小心
宁	宀丁
凝	冫匕矢龴疋
狞	犭宀丁
拧	扌宀丁
柠	木宀丁
咛	口宀丁
泞	氵宀丁
佞	亻二女
甯	宀心用
苧	艹宀丁
聍	耳宀丁
牛	𠂉十
扭	扌丑
纽	纟丑
妞	女丑
钮	钅丑
忸	忄丑
狃	犭丑
农	冖𧘇
浓	氵冖𧘇
哝	口冖𧘇
侬	亻冖𧘇
脓	⺼冖𧘇
秾	禾冖𧘇
𬪩	酉冖𧘇
耨	耒辰寸
怒	女又心
努	女又力
奴	女又
弩	女又弓
驽	女又马
孥	女又子
傉	亻辰寸
胬	女又肉
砮	女又石
笯	竹女又
暖	日爫一𠂇又
诺	讠艹𠂇口
挪	扌𭃂⻏
懦	忄雨而
喏	口艹𠂇口
糯	米雨而
傩	亻又亻{隹右}
搦	扌𢎥𢎥
锘	钅艹𠂇口
女	𡿨丿一
钕	钅女
恧	而心
衄	丿皿丑
虐	虍𰀂
疟	疒𰀂
噢	口丿冂釆大
喔	口尸𠫔土
欧	区欠
偶	亻田冂一丶
呕	口区
殴	区殳
鸥	区鸟
藕	艹耒田冂一丶
区	匚㐅
怄	忄区
瓯	区瓦
讴	讠区
沤	氵区
耦	耒田冂一丶
𠙶	凵了
𬉼	火区
怕	忄白
爬	爪巴
帕	巾白
啪	口扌白
趴	𧾷八
琶	𤣩王巴
葩	艹白巴
杷	木巴
筢	竹扌巴
舥	舟巴
潖	氵𤣩王巴
派	氵𠂆{𧘇}
排	扌非
拍	扌白
牌	片{卑上}十
徘	彳非
湃	氵龵一丰
俳	亻非
哌	口𠂆{𧘇}
簰	竹片{卑上}十
蒎	艹氵𠂆{𧘇}
迫	辶白
盘	舟皿
判	半刂
叛	半𠂆又
盼	目分
潘	氵釆田
攀	木木乂乂大手
畔	田半
蹒	𧾷艹两
磐	舟殳石
蟠	虫釆田
槃	舟殳木
爿	𠃊丆丨
泮	氵半
袢	衤半
磻	石釆田
襻	衤木木乂乂大手
胖	⺼半
旁	亠丷冖方
庞	广龙
彷	彳方
乓	丘丶
螃	虫亠丷冖方
滂	氵亠丷冖方
逄	辶夂㐄
雱	雨方
耪	耒亠丷冖方
鳑	鱼亠丷冖方
跑	𧾷包
泡	氵包
抛	扌九力
袍	衤包
咆	口包
庖	广包
狍	犭包
疱	疒包
匏	大一丂包
脬	⺼爫子
陪	⻖立口
配	酉己
佩	亻𠘨一巾
培	土立口
赔	贝立口
裴	非衣
沛	氵巿
呸	口丕
胚	⺼丕
帔	巾皮
辔	纟车纟口
霈	雨氵巿
旆	方𠂉巿
醅	酉立口
锫	钅立口
衃	丿皿不
喷	口十廾贝
盆	分皿
湓	氵分皿
碰	石丷一业
朋	月月
鹏	月月鸟
捧	扌𡗗𰀁
砰	石平
蓬	艹辶夂丰
篷	竹辶夂丰
彭	士口䒑彡
棚	木月月
膨	⺼士口䒑彡
澎	氵士口䒑彡
怦	忄平
嘭	口士口䒑彡
烹	亠口了灬
抨	扌平
芃	艹凡
硼	石月月
蟛	虫士口䒑彡
堋	土月月
椪	木丷一业
弸	弓月月
淜	氵月月
皮	{乛丿丨}又
批	扌匕匕
屁	尸匕匕
疲	疒皮
匹	匚儿
劈	尸口辛刀
披	扌皮
脾	⺼{卑上}十
啤	口{卑上}十
僻	亻尸口辛
霹	雨尸口辛
痞	疒不口
譬	尸口辛亠二口
噼	口尸口辛
琵	𤣩王匕匕
癖	疒尸口辛
媲	女丿囗㐅匕匕
丕	不一
毗	田匕匕
坯	土丕
纰	纟匕匕
睥	目{卑上}十
邳	不一⻏
砒	石匕匕
貔	豸丿囗㐅匕匕
枇	木匕匕
罴	罒去灬
圮	土己
鼙	士口䒑支{卑上}十
蚍	虫匕匕
铍	钅皮
郫	{卑上}十⻏
仳	亻匕匕
伾	亻丕
蜱	虫{卑上}十
埤	土{卑上}十
嚭	士口䒑口不口
陴	⻖{卑上}十
淠	氵田丌
甓	尸口辛瓦
狉	犭丕
澼	氵尸口辛
鲏	鱼皮
䴙	尸口辛鸟
苉	艹匹
𬳵	马丕
片	丿丄𠃍
偏	亻户冂卄
骗	马户冂卄
篇	竹户冂卄
翩	户冂卄习习
骈	马丷开
蹁	𧾷户冂卄
谝	讠户冂卄
胼	⺼丷开
犏	牜户冂卄
楩	木亻更
㛹	女亻更
𡎚	土户冂卄
飘	覀示风
漂	氵覀示
票	覀示
瞟	目覀示
嫖	女覀示
瓢	覀示瓜
缥	纟覀示
剽	覀示刂
朴	木卜
殍	歹爫子
嘌	口覀示
螵	虫覀示
蔈	艹覀示
薸	艹氵覀示
撇	扌⺌冂小攵
瞥	⺌冂小攵目
苤	艹丕
氕	气丿
𬭯	钅⺌冂小攵
品	口口口
拼	扌丷开
贫	分贝
频	止𣥂页
聘	耳由丂
嫔	女宀丘八
颦	止𣥂页{卑上}十
姘	女丷开
牝	牜匕
玭	𤣩匕匕
𬞟	艹止𣥂页
平	一丷十
凭	亻丿士几
评	讠平
瓶	丷开瓦
萍	艹氵平
苹	艹平
坪	土平
乒	丘丿
娉	女由丂
枰	木平
鲆	鱼平
俜	亻由丂
泙	氵平
洴	氵丷开
帡	巾丷开
荓	艹丷开
蚲	虫平
涄	氵由丂
玶	𤣩平
破	石皮
婆	氵皮女
颇	皮页
坡	土皮
魄	白鬼
泼	氵{𠃊丿}丶又
珀	𤣩白
叵	匚口
鄱	釆田⻏
粕	米白
笸	竹匚口
皤	白釆田
钋	钅卜
钷	钅匚口
桲	木十冖子
䥽	钅{𠃊丿}丶又
酦	酉{𠃊丿}丶又
剖	立口刂
抔	扌不
裒	衣臼
掊	扌立口
普	丷一业日
扑	扌卜
铺	钅甫
仆	亻卜
谱	讠丷一业日
葡	艹勹甫
菩	艹立口
噗	口业䒑夫
浦	氵甫
蒲	艹氵甫
濮	氵亻业䒑夫
璞	𤣩业䒑夫
圃	囗甫
溥	氵甫寸
匍	勹甫
莆	艹甫
蹼	𧾷业䒑夫
氆	毛丷一业日
潽	氵丷一业日
酺	酉甫
镨	钅丷一业日
镤	钅业䒑夫
蒱	艹扌甫
墣	土业䒑夫
穙	禾业䒑夫
起	土龰己
气	𠂉一⺄
其	卄二一八
七	一乚
器	口口犬口口
骑	马大可
齐	文{⿰丿丨}
弃	亠厶廾
妻	{十⺕}女
企	𠆢止
启	户口
旗	方𠂉卄二一八
欺	卄二一八欠
岂	山己
汽	氵气
棋	木卄二一八
琪	𤣩卄二一八
泣	氵立
凄	冫{十⺕}女
漆	氵木人氺
戚	戊上小
契	丰刀大
乞	𠂉乙
祈	礻斤
麒	鹿卄二一八
歧	止支
琦	𤣩大可
祁	礻⻏
绮	纟大可
栖	木西
炁	旡灬
淇	氵卄二一八
崎	山大可
砌	石七刀
蹊	𧾷爫幺大
祺	礻卄二一八
迄	辶𠂉乙
杞	木己
岐	山支
脐	⺼齐
颀	斤页
沏	氵七刀
跂	𧾷支
憩	舌自心
萋	艹{十⺕}女
嘁	口戊上小
耆	老日
芑	艹己
蜞	虫卄二一八
讫	讠𠂉乙
祇	礻氏
鳍	鱼老日
亓	一丌
葺	艹口耳
柒	氵七木
綦	卄二一八糸
蕲	艹单斤
畦	田土土
芪	艹氏
圻	土斤
萁	艹卄二一八
骐	马卄二一八
欹	大可欠
碛	石龶贝
汔	氵𠂉乙
锜	钅大可
槭	木戊上小
蛴	虫齐
屺	山己
玘	𤣩己
桤	木山己
埼	土大可
棨	户攵木
郪	{十⺕}女⻏
磜	石𱼀龴示
鲯	鱼卄二一八
愭	忄老日
碶	石丰刀大
俟	亻厶矢
婍	女大可
洓	氵朿
䓫	艹大可
𨙸	支⻏
𬨂	车氏
恰	忄𠆢一口
掐	扌⺈臼
洽	氵𠆢一口
拤	扌上卜
葜	艹丰刀大
袷	衤𠆢一口
髂	冎⺼宀夂口
前	丷一⺝刂
钱	钅戋
千	丿十
潜	氵夫夫曰
牵	大冖牛
倩	亻龶⺝
浅	氵戋
签	竹佥
歉	兼欠
欠	⺈人
乾	十十日𠂉乙
谦	讠兼
迁	辶千
遣	辶中一㠯
茜	艹西
芊	艹千
嵌	山甘欠
虔	虍文
铅	钅𠘧口
谴	讠辶中一㠯
钳	钅甘
黔	{里}灬𠆢一㇇
堑	车斤土
骞	宀𠀎八马
佥	𠆢一𭕄一
仟	亻千
缱	纟辶中一㠯
纤	纟千
阡	⻖千
钎	钅千
钤	钅𠆢一㇇
掮	扌户⺝
芡	艹欠
荨	艹彐寸
扦	扌千
愆	彳一丁氵心
悭	忄丨丨又土
搴	宀𠀎八手
慊	忄兼
褰	宀𠀎八衣
汧	氵开
肷	⺼欠
蒨	艹亻龶⺝
靬	革干
椠	车斤木
杄	木千
鹐	⺈臼鸟
岍	山开
圲	土千
伣	亻见
墘	土十十日𠂉乙
磏	石兼
𬘬	纟龶⺝
枪	木𠆢㔾
墙	土土丷囗口
抢	扌𠆢㔾
腔	⺼宀八工
呛	口𠆢㔾
跄	𧾷𠆢㔾
蔷	艹土丷囗口
锵	钅丬夕寸
羌	⺶乚
戕	爿戈
戗	𠆢㔾戈
襁	衤弓口虫
嫱	女土丷囗口
樯	木土丷囗口
镪	钅弓口虫
炝	火𠆢㔾
羟	羊𢀖
蜣	虫⺶乚
玱	𤣩𠆢㔾
锖	钅龶⺝
蔃	艹弓口虫
巧	工丂
悄	忄⺌⺝
瞧	目亻{隹右}灬
敲	亠口冂口⺊又
桥	木夭{⿰丿丨}
乔	夭{⿰丿丨}
俏	亻⺌⺝
翘	𫠠丿兀习习
窍	宀八工丂
鞘	革⺌⺝
憔	忄亻{隹右}灬
峭	山⺌⺝
跷	𧾷𫠠丿兀
侨	亻夭{⿰丿丨}
樵	木亻{隹右}灬
撬	扌毛毛毛
锹	钅禾火
谯	讠亻{隹右}灬
橇	木毛毛毛
诮	讠⺌⺝
荞	艹夭{⿰丿丨}
愀	忄禾火
劁	亻{隹右}灬刂
硗	石𫠠丿兀
鞒	革夭{⿰丿丨}
硚	石夭{⿰丿丨}
缲	纟口口口木
雀	小亻{隹右}
且	⺝一
切	七刀
窃	宀八七刀
怯	忄去
妾	立女
惬	忄匚夹
锲	钅丰刀大
挈	丰刀手
箧	竹匚夹
郄	㐅𠂇厶⻏
亲	立木
秦	𡗗禾
琴	𤣩王𠆢一㇇
侵	亻⺕冖又
勤	廿中王力
寝	宀丬⺕冖又
擒	扌𠆢亠凶禸
钦	钅欠
芹	艹斤
沁	氵心
禽	𠆢亠凶禸
覃	覀日十
噙	口𠆢亠凶禸
衾	𠆢一㇇衣
揿	扌钅欠
芩	艹𠆢一㇇
溱	氵𡗗禾
吣	口心
嗪	口𡗗禾
锓	钅⺕冖又
檎	木𠆢亠凶禸
骎	马⺕冖又
慬	忄廿中王
嵚	山钅欠
请	讠龶⺝
轻	车𢀖
清	氵龶⺝
青	龶⺝
情	忄龶⺝
庆	广大
晴	日龶⺝
倾	亻匕页
卿	𠂎卩{艮}
擎	艹句攵手
顷	匕页
蜻	虫龶⺝
箐	竹龶⺝
氢	气𢀖
罄	士𠃜殳缶
磬	士𠃜殳石
綮	户攵糸
氰	气龶⺝
黥	{里}灬亠口小
檠	艹句攵木
鲭	鱼龶⺝
苘	艹冂口
圊	囗龶⺝
碃	石龶⺝
庼	广匕页
勍	亠口小力
穷	宀八力
琼	𤣩亠口小
穹	宀八弓
茕	艹冖⺄十
邛	工⻏
筇	竹工⻏
蛩	工凡虫
銎	工凡金
䓖	艹宀八力
求	𬺰冫丿丶丶
球	𤣩求
秋	禾火
丘	斤一
邱	丘⻏
囚	囗人
裘	求衣
酋	丷酉
虬	虫乚
糗	米自犬
鳅	鱼禾火
蚯	虫丘
俅	亻求
泅	氵囗人
遒	辶丷酉
逑	辶求
楸	木禾火
犰	犭九
萩	艹禾火
蝤	虫丷酉
璆	𤣩习习𠆢彡
巯	𢀖厶一𫶧
赇	贝求
鹙	禾火鸟
鞧	革丷酉
鼽	自田丌九
訄	九亠二口
𨱇	钅求
去	土厶
取	耳又
趣	土龰耳又
曲	囗艹
屈	尸出
躯	身区
驱	马区
娶	耳又女
趋	土龰⺈彐
渠	氵巨木
觑	虍业见
瞿	目目亻{隹右}
岖	山区
蛐	虫曲
蛆	虫且
衢	彳一丁目目亻{隹右}
祛	礻去
黢	{里}灬允夂
癯	疒目目亻{隹右}
阒	门目犬
龋	止凵人禹
蕖	艹氵巨木
蘧	艹辶虍豕
朐	月句
璩	𤣩虍豕
劬	句力
磲	石氵巨木
诎	讠出
蠼	虫目目亻{隹右}又
袪	衤去
氍	目目亻{隹右}毛
鸲	句鸟
麹	龶夂勹米
胠	⺼去
灈	氵目目亻{隹右}
鼩	臼{鼠下}句
竘	立句
戌	戊{一}
㭕	木去
䓛	艹尸出
坥	土且
𪨰	山曲
𫭟	土区
全	𠆢王
权	木又
拳	龹手
劝	又力
泉	白水
犬	大丶
券	龹刀
蜷	虫龹㔾
痊	疒𠆢王
诠	讠𠆢王
荃	艹𠆢王
颧	艹口口亻{隹右}页
绻	纟龹㔾
铨	钅𠆢王
筌	竹𠆢王
鬈	E一厶彡龹㔾
醛	酉艹𠆢王
悛	忄允夂
佺	亻𠆢王
畎	田犬
棬	木龹㔾
鳈	鱼白水
辁	车𠆢王
婘	女龹㔾
瑔	𤣩白水
𨟠	目目亻{隹右}⻏
却	去卩
确	石⺈用
缺	缶夬
瘸	疒力口肉
鹊	卄一日鸟
阙	门屰欠
阕	门癶天
榷	木冖亻{隹右}
炔	火夬
悫	士冗心
碏	石卄一日
埆	土⺈用
𬒈	⺍冖石
群	尹口羊
裙	衤尹口
逡	辶允夂
囷	囗禾
然	𱼀犬灬
染	氵九木
燃	火𱼀犬灬
冉	冂土
髯	E一厶彡冉
苒	艹冉
蚺	虫冉
䎃	冉习习
让	讠上
嚷	口襄
壤	土襄
攘	扌襄
瓤	襄瓜
禳	礻襄
穰	禾襄
瀼	氵襄
蘘	艹襄
儴	亻襄
绕	纟𫠠丿兀
扰	扌尤
饶	饣𫠠丿兀
娆	女𫠠丿兀
桡	木𫠠丿兀
荛	艹𫠠丿兀
热	扌丸灬
惹	艹𠂇口心
人	丿乀
任	亻丿士
认	讠人
忍	刃心
仁	亻二
刃	刀丶
韧	韦刃
壬	丿士
饪	饣丿士
仞	亻刃
纫	纟刃
稔	禾𠆢一㇇心
荏	艹亻丿士
妊	女丿士
衽	衤丿士
轫	车刃
纴	纟丿士
讱	讠刃
葚	艹卄二匸八
仍	亻乃
扔	扌乃
日	囗一
驲	马日
容	宀谷
荣	艹冖木
融	鬲虫
蓉	艹宀谷
绒	纟戈十
溶	氵宀谷
戎	戈十
榕	木宀谷
茸	艹耳
熔	火宀谷
冗	冖几
嵘	山艹冖木
镕	钅宀谷
蝾	虫艹冖木
狨	犭戈十
瑢	𤣩宀谷
肉	内人
柔	矛木
揉	扌矛木
蹂	𧾷矛木
糅	米矛木
鞣	革矛木
𫐓	车矛木
如	女口
入	丿乀
辱	辰寸
乳	爫子乚
儒	亻雨而
茹	艹女口
汝	氵女
蠕	虫雨而
孺	子雨而
褥	衤辰寸
嚅	口雨而
濡	氵雨而
缛	纟辰寸
襦	衤雨而
溽	氵辰寸
蓐	艹辰寸
洳	氵女口
薷	艹雨而
颥	雨而页
嬬	女雨而
铷	钅女口
软	车欠
阮	⻖元
堧	土而大
瓀	𤣩雨而
媆	女而大
瑞	𤣩山而
锐	钅丷兄
蕊	艹心心心
睿	⺊冖一{八人}目
芮	艹内
蚋	虫内
蕤	艹豕生
枘	木内
汭	氵内
润	氵门王
闰	门王
若	艹𠂇口
弱	𢎥𢎥
偌	亻艹𠂇口
箬	竹艹𠂇口
婼	女艹𠂇口
爇	艹土儿土丸灬
蒻	艹𢎥𢎥
鄀	艹𠂇口⻏
撒	扌卄一⺼攵
洒	氵西
飒	立风
仨	亻三
萨	艹⻖亠丷厂
卅	一川
靸	革及
挲	氵少手
潵	氵卄一⺼攵
脎	⺼㐅木
赛	宀𠀎八贝
塞	宀𠀎八土
腮	⺼田心
噻	口宀𠀎八土
鳃	鱼田心
三	一二
散	卄一⺼攵
伞	𠆢{伞下}
叁	厶大三
馓	饣卄一⺼攵
毵	厶大彡毛
糁	米厶大彡
丧	土丷{𧘇-丿}
桑	又又又木
嗓	口又又又木
搡	扌又又又木
颡	又又又木页
磉	石又又又木
扫	扌彐
骚	马叉虫
嫂	女𦥔又
搔	扌叉虫
臊	⺼口口口木
瘙	疒叉虫
缫	纟巛果
埽	土彐冖巾
溞	氵叉虫
色	⺈巴
瑟	𤣩王必
涩	氵刃止
啬	土丷囗口
穑	禾土丷囗口
铯	钅⺈巴
璱	𤣩𤣩王必
森	木木木
僧	亻丷囗⺌日
啥	口𠆢一古
傻	亻丿囗㐅儿夊
杀	㐅木
莎	艹氵少
煞	⺈彐攵灬
纱	纟少
沙	氵少
厦	厂𦣻夂
霎	雨立女
砂	石少
鲨	氵少鱼
裟	氵少衣
铩	钅㐅木
嗄	口𦣻夂
歃	千臼欠
痧	疒氵少
唼	口立女
杉	木彡
晒	日西
筛	竹リ一巾
山	凵丨
删	册刂
闪	门人
善	羊䒑口
扇	户习习
衫	衤彡
珊	𤣩册
擅	扌亠囗口旦
姗	女册
讪	讠山
陕	⻖夹
煽	火户习习
膳	⺼羊䒑口
跚	𧾷册
潸	氵林⺝
缮	纟羊䒑口
汕	氵山
赡	贝⺈厂八亠二口
鳝	鱼羊䒑口
舢	舟山
苫	艹占
嬗	女亠囗口旦
鄯	羊䒑口⻏
骟	马户习习
蟮	虫羊䒑口
墡	土羊䒑口
剡	火火刂
疝	疒山
芟	艹殳
埏	土廴正
钐	钅彡
嶦	山⺈厂八亠二口
晱	日火火
栅	木册
烻	火廴正
𫮃	土丷田十
上	⺊一
伤	亻𠂉力
商	亠丷冂八口
尚	⺌冂口
赏	龸口贝
晌	日丿冂口
殇	歹𠂉𠄎丿丿
觞	⺈用𠂉𠄎丿丿
熵	火亠丷冂八口
墒	土亠丷冂八口
绱	纟⺌冂口
垧	土丿冂口
少	小丿
烧	火𫠠丿兀
稍	禾⺌⺝
绍	纟刀口
哨	口⺌⺝
邵	刀口⻏
勺	勹丶
梢	木⺌⺝
韶	立日刀口
劭	刀口力
捎	扌⺌⺝
芍	艹勺
苕	艹刀口
艄	舟⺌⺝
筲	竹⺌⺝
潲	氵禾⺌⺝
蛸	虫⺌⺝
睄	目⺌⺝
召	刀口
柖	木刀口
玿	𤣩刀口
射	身寸
设	讠殳
舍	𠆢一古
蛇	虫宀匕
舌	千口
涉	氵止𣥂
摄	扌耳又又
社	礻土
奢	大耂日
慑	忄耳又又
赦	赤攵
折	扌斤
佘	𠆢示
麝	鹿身寸
赊	贝𠆢示
畲	𠆢示田
猞	犭𠆢一古
歙	𠆢一口习习欠
滠	氵耳又又
厍	厂车
拾	扌𠆢一口
𪨶	山大车
谁	讠亻{隹右}
神	礻申
深	氵⺳木
身	自才
甚	卄二匸八
什	亻十
伸	亻申
沈	氵冖儿
审	宀申
申	田丨
慎	忄十{具-八}八
呻	口申
渗	氵厶大彡
婶	女宀申
绅	纟申
肾	丨丨又⺝
莘	艹辛
珅	𤣩申
蜃	辰虫
哂	口西
娠	女辰
燊	火火火木
瘆	疒厶大彡
椹	木卄二匸八
砷	石申
诜	讠⺧儿
甡	生生
谂	讠𠆢一㇇心
矧	矢弓丨
胂	⺼申
侁	亻⺧儿
瞫	目覀日十
鲹	鱼厶大彡
屾	山山
𬬹	钅申
𬳽	马⺧儿
生	丿龶
声	士𠃜
圣	又土
胜	⺼生
升	丿廾
省	少目
剩	千北人刂
绳	纟口电
牲	牜生
笙	竹生
甥	生田力
昇	日丿廾
嵊	山千北人
眚	生目
陞	⻖丿廾土
是	日一龰
时	日寸
事	古丨{肀亅}
实	宀大⺀
十	一丨
师	リ一巾
使	亻吏
屎	尸米
世	廿𠃊
始	女厶口
失	丿夫
士	十一
湿	氵日业
识	讠只
视	礻见
势	扌丸力
市	亠巾
室	宀𠫔土
式	弋工
示	二小
试	讠弋工
史	口丿乀
食	𠆢丶艮
施	方𠂉也
适	辶舌
释	釆又𰀁
诗	讠土寸
尸	𠃍一丿
氏	丿𠃊一乚
侍	亻土寸
饰	饣𠂉巾
誓	扌斤亠二口
驶	马史
逝	辶扌斤
狮	犭リ一巾
噬	口竹工人人
仕	亻士
矢	𠂉大
拭	扌弋工
嗜	口老日
似	亻𠄌丶人
蚀	饣虫
恃	忄土寸
柿	木亠巾
弑	㐅木弋工
轼	车弋工
虱	⺄丿虫
谥	讠丷一八皿
舐	舌氏
媞	女日一龰
豕	一𧰨
莳	艹日寸
筮	竹工人人
蓍	艹老日
螫	赤攵虫
炻	火石
鲥	鱼日寸
奭	大百百
湜	氵日一龰
埘	土日寸
酾	酉一冂丶冂丶
祏	礻石
栻	木弋工
贳	世贝
铈	钅亠巾
鲺	鱼⺄丿虫
鼫	臼{鼠下}石
邿	土寸⻏
鸤	尸鸟
嘘	口虍业
峙	山土寸
殖	歹十{具-八}
浉	氵リ一巾
襫	衤大百百
䏡	⺼示
䴓	帀鸟
𫚕	鱼リ一巾
𬤊	讠日一龰
手	丿于
受	爫冖又
收	丩攵
首	丷一自
守	宀寸
熟	亠口子丸灬
兽	丷田一口
授	扌爫冖又
瘦	疒𦥔又
售	亻{隹右}口
寿	{寿上丰}寸
狩	犭宀寸
绶	纟爫冖又
艏	舟丷一自
书	𠃍𠃌丨丶
数	米女攵
术	木丶
树	木又寸
属	尸禹
叔	上小又
束	古丨丨人
舒	𠆢一古予
输	车𠆢一月刂
述	辶术
殊	歹丿未
鼠	臼{鼠下}
疏	⺪厶一𫶧
淑	氵上小又
竖	丨丨又立
署	罒耂日
墅	里予土
梳	木厶一𫶧
蜀	⺫勹虫
恕	女口心
倏	亻丨攵犬
暑	日耂日
庶	广廿灬
漱	氵束欠
赎	贝十乛大⺀
姝	女丿未
枢	木区
蔬	艹⺪厶一𫶧
薯	艹罒耂日
曙	日罒耂日
抒	扌予
孰	亠口子丸
戍	戊丶
塾	亠口子丸土
纾	纟予
澍	氵士口䒑寸
黍	禾人氺
沭	氵术
秫	禾术
殳	几又
菽	艹上小又
腧	⺼𠆢一月刂
毹	𠆢一月刂毛
摅	扌虍心
婌	女上小又
鄃	𠆢一月刂⻏
隃	⻖𠆢一月刂
陎	⻖丿未
𬬸	钅术
刷	尸巾刂
耍	而女
唰	口尸巾刂
帅	リ巾
摔	扌亠幺冫丿丶十
甩	用乚
衰	衣{⿻口一}
蟀	虫亠幺冫丿丶十
栓	木𠆢王
拴	扌𠆢王
涮	氵尸巾刂
闩	门一
腨	⺼山而
双	又又
爽	大乂乂乂乂
霜	雨木目
孀	女雨木目
鹴	雨木目鸟
骦	马雨木目
礵	石雨木目
水	丨㇇丿ㄟ
睡	目千艹士
税	禾丷兄
帨	巾丷兄
说	讠丷兄
顺	川页
瞬	目爫冖夕㐄
吮	口允
舜	爫冖夕㐄
楯	木𠂆十目
烁	火乐
硕	石页
朔	屰月
铄	钅乐
槊	屰月木
搠	扌屰月
妁	女勺
蒴	艹屰月
死	歹匕
四	囗儿
思	田心
斯	卄二一八斤
司	𠃌一口
丝	{纟上}{纟上}一
私	禾厶
寺	土寸
撕	扌卄二一八斤
肆	E一厶聿
嘶	口卄二一八斤
厮	厂卄二一八斤
祀	礻巳
嗣	口冂卄𠃌一口
饲	饣𠃌一口
巳	コ乚
泗	氵四
咝	口丝
姒	女𠄌丶人
汜	氵巳
驷	马四
鸶	{纟上}{纟上}一鸟
兕	凹儿
涘	氵厶矢
缌	纟田心
蛳	虫リ一巾
澌	氵卄二一八斤
锶	钅田心
笥	竹𠃌一口
耜	耒㠯
飔	风田心
凘	冫卄二一八斤
虒	𠂆虍几
㟃	山𠃌一口
楒	木田心
送	辶丷天
松	木公
宋	宀木
耸	人人耳
诵	讠龴用
怂	人人心
𪨊	尸人人
颂	公页
嵩	山亠口冂口
悚	忄束
讼	讠公
忪	忄公
淞	氵木公
崧	山木公
竦	立束
凇	冫木公
菘	艹木公
娀	女戈十
㧐	扌又又
搜	扌𦥔又
艘	舟𦥔又
嗽	口束欠
嗖	口𦥔又
叟	𦥔又
飕	风𦥔又
擞	扌米女攵
馊	饣𦥔又
薮	艹米女攵
廋	广𦥔又
溲	氵𦥔又
嗾	口方𠂉矢
锼	钅𦥔又
瞍	目𦥔又
蒐	艹鬼
螋	虫𦥔又
诉	讠斥
速	辶束
苏	艹办
素	龶糸
宿	宀亻百
俗	亻谷
肃	肀{⿰丿丨}八
塑	屰月土
酥	酉禾
簌	竹束欠
粟	覀米
稣	鱼禾
溯	氵屰月
愫	忄龶糸
夙	几歹
谡	讠田八夂
窣	宀八亠人人十
蔌	艹束欠
涑	氵束
嗉	口龶糸
僳	亻覀米
觫	⺈用束
骕	马肀{⿰丿丨}八
甦	更生
鹔	肀{⿰丿丨}八鸟
傃	亻龶糸
蹜	𧾷宀亻百
缩	纟宀亻百
𫗧	饣束
算	竹目廾
酸	酉允夂
蒜	艹示示
狻	犭允夂
虽	口虫
随	⻖辶𠂇月
岁	山夕
碎	石亠人人十
遂	辶丷豕
隋	⻖𠂇工月
髓	冎⺼辶𠂇工月
祟	出示
穗	禾{惠-心}心
邃	辶穴丷豕
隧	⻖辶丷豕
绥	纟爫女
燧	火辶丷豕
睢	目亻{隹右}
眭	目土土
荽	艹爫女
谇	讠亠人人十
濉	氵目亻{隹右}
穟	禾辶丷豕
璲	𤣩辶丷豕
襚	衤辶丷豕
旞	方𠂉辶丷豕
𫟦	车辶丷豕
𬭼	钅辶丷豕
孙	子小
损	扌口贝
笋	竹尹
隼	亻{隹右}十
荪	艹子小
狲	犭子小
榫	木亻{隹右}十
飧	夕𠆢丶艮
所	戶斤
索	十冖糸
锁	钅⺌贝
嗦	口十冖糸
梭	木允夂
琐	𤣩⺌贝
唆	口允夂
娑	氵少女
蓑	艹衣{⿻口一}
桫	木氵少
唢	口⺌贝
睃	目允夂
嗍	口屰月
羧	羊允夂
溹	氵十冖糸
他	亻也
她	女也
它	宀匕
塔	土艹𠆢一口
踏	𧾷水日
拓	扌石
塌	土日习习
榻	木日习习
蹋	𧾷日习习
遢	辶日习习
挞	扌辶大
趿	𧾷及
獭	犭束⺈贝
祂	礻也
闼	门辶大
鳎	鱼日习习
铊	钅宀匕
溻	氵日习习
阘	门日习习
褟	衤日习习
鞳	革艹𠆢一口
太	大丶
台	厶口
态	太心
抬	扌厶口
泰	𡗗氺
胎	⺼厶口
汰	氵太
苔	艹厶口
跆	𧾷厶口
钛	钅太
邰	厶口⻏
薹	艹士口冖𠫔土
肽	⺼太
炱	厶口火
酞	酉太
鲐	鱼厶口
谈	讠火火
叹	口又
探	扌⺳木
坦	土旦
贪	𠆢一㇇贝
坛	土云
摊	扌又亻{隹右}
滩	氵又亻{隹右}
谭	讠覀日十
潭	氵覀日十
瘫	疒又亻{隹右}
毯	毛火火
炭	山𠂇火
忐	上心
檀	木亠囗口旦
痰	疒火火
碳	石山𠂇火
袒	衤旦
昙	日云
坍	土丹
郯	火火⻏
倓	亻火火
锬	钅火火
钽	钅旦
璮	𤣩亠囗口旦
惔	忄火火
菼	艹火火
榃	木木田
磹	石覀日十
躺	身⺌冂口
汤	氵𠄎丿丿
糖	米广肀口
趟	土龰⺌冂口
烫	氵𠄎丿丿火
堂	龸口土
唐	广肀口
膛	⺼龸口土
倘	亻⺌冂口
淌	氵⺌冂口
棠	龸口木
塘	土广肀口
搪	扌广肀口
螳	虫龸口土
傥	亻龸兄
瑭	𤣩广肀口
镗	钅龸口土
帑	女又巾
樘	木龸口土
蹚	𧾷龸口土
嘡	口龸口土
溏	氵广肀口
螗	虫广肀口
羰	羊山𠂇火
镋	钅龸兄
耥	耒⺌冂口
埫	土⺌冂口
铴	钅氵𠄎丿丿
䣘	龸口土⻏
鄌	广肀口⻏
套	大E一厶
逃	辶兆
讨	讠寸
桃	木兆
涛	氵{寿上丰}寸
掏	扌勹缶
陶	⻖勹缶
滔	氵爫臼
萄	艹勹缶
淘	氵勹缶
韬	韦爫臼
焘	{寿上丰}寸灬
啕	口勹缶
饕	口丂虍几𠆢丶艮
绦	纟夂木
洮	氵兆
梼	木{寿上丰}寸
绹	纟勹缶
弢	弓屮又
鼗	兆士口䒑支
慆	忄爫臼
𫘦	马勹缶
特	牜土寸
忑	下心
慝	匚艹𠂇口心
铽	钅弋心
忒	弋心
疼	疒冬
腾	月龹马
藤	艹月龹氺
滕	月龹氺
誊	龹亠二口
螣	月龹虫
縢	月龹糸
熥	火辶龴用
䲢	月𠔉鱼
题	日一龰页
体	亻本
替	夫夫曰
踢	𧾷日勿
梯	木丷𢎨
蹄	𧾷亠丷冖巾
惕	忄日勿
涕	氵丷𢎨
啼	口亠丷冖巾
剔	日勿刂
屉	尸世
剃	丷𢎨刂
嚏	口十冖田疋
倜	亻⺆土口
缇	纟日一龰
逖	辶犭火
荑	艹夷
醍	酉日一龰
悌	忄丷𢎨
鹈	丷𢎨鸟
绨	纟丷𢎨
锑	钅丷𢎨
裼	衤日勿
趯	土龰习习亻{隹右}
遆	辶亠丷冖巾
鳀	鱼日一龰
擿	扌辶亠丷冂古
䏲	⺼丷𢎨
䴘	𠂆虍几鸟
瑅	𤣩日一龰
𫘨	马日一龰
天	一大
田	囗十
甜	舌甘
添	氵天⺗
填	土十{具-八}八
舔	舌天⺗
恬	忄舌
腆	⺼{曲-一}一八
阗	门十{具-八}八
殄	歹𠆢彡
忝	天⺗
湉	氵忄舌
畋	田攵
觍	{曲-一}一八见
瑱	𤣩十{具-八}八
掭	扌天⺗
盷	目匀
淟	氵{曲-一}一八
晪	日{曲-一}一八
沺	氵田
黇	黄占
条	夂木
跳	𧾷兆
挑	扌兆
眺	目兆
迢	辶刀口
窕	宀八兆
佻	亻兆
笤	竹刀口
祧	礻兆
髫	E一厶彡刀口
粜	出米
龆	止凵人刀口
蜩	虫⺆土口
鲦	鱼夂木
朓	月兆
嬥	女习习亻{隹右}
铁	钅丿夫
贴	贝占
帖	巾占
餮	歹𠆢彡𠆢丶艮
萜	艹巾占
听	口斤
停	亻亠口冖丁
厅	厂丁
挺	扌廴丿土
庭	广廴丿土
廷	廴丿土
婷	女亠口冖丁
亭	亠口冖丁
艇	舟廴丿土
霆	雨廴丿土
汀	氵丁
蜓	虫廴丿土
铤	钅廴丿土
葶	艹亠口冖丁
莛	艹廴丿土
珽	𤣩廴丿土
梃	木廴丿土
烃	火𢀖
渟	氵亠口冖丁
颋	廴丿土页
桯	木口王
侹	亻廴丿土
䗴	虫竹廴丿土
圢	土丁
烶	火廴丿土
𬘩	纟廴丿土
同	冂一口
通	辶龴用
痛	疒龴用
统	纟亠允
童	立里
铜	钅冂一口
筒	竹冂一口
桶	木龴用
捅	扌龴用
瞳	目立里
桐	木冂一口
佟	亻冬
彤	丹彡
恸	忄云力
潼	氵立里
嗵	口辶龴用
僮	亻立里
酮	酉冂一口
仝	𠆢工
茼	艹冂一口
曈	日立里
砼	石𠆢工
烔	火冂一口
橦	木立里
哃	口冂一口
穜	禾立里
鲖	鱼冂一口
㛚	女龴用
峂	山冬
𦒍	立里习习
𫍣	讠冂一口
头	大⺀
投	扌殳
偷	亻𠆢一月刂
透	辶禾乃
骰	冎⺼殳
突	宀八犬
图	囗冬
土	十一
徒	彳土龰
吐	口土
途	辶𠆢一朩
涂	氵𠆢一朩
屠	尸耂日
兔	⺈𫩏儿丶
秃	禾几
凸	丨一丨㇎一
荼	艹𠆢一朩
菟	艹兔
钍	钅土
堍	土兔
酴	酉𠆢一朩
稌	禾𠆢一朩
腯	⺼𠂆十目
葖	艹宀八犬
梌	木𠆢一朩
㻬	𤣩雨一丂
𬳿	马𠆢一朩
团	囗才
湍	氵山而
抟	扌专
彖	彑𧰨
疃	田立里
猯	犭山而
煓	火山而
推	扌亻{隹右}
退	辶艮
腿	⺼辶艮
颓	禾几页
褪	衤辶艮
蜕	虫丷兄
煺	火辶艮
魋	鬼亻{隹右}
𬯎	⻖中一贝
吞	天口
屯	一凵乚
臀	尸共殳⺝
豚	⺼豕
饨	饣屯
暾	日亠口子攵
鲀	鱼屯
坉	土屯
忳	忄屯
焞	火亠口子
拖	扌𠂉也
脱	⺼丷兄
托	扌丿七
妥	爫女
陀	⻖宀匕
驼	马宀匕
唾	口千艹士
佗	亻宀匕
椭	木⻖𠂇月
坨	土宀匕
沱	氵宀匕
砣	石宀匕
鸵	{鸟减一}一宀匕
跎	𧾷宀匕
柁	木宀匕
酡	酉宀匕
橐	𰀉冖石木
柝	木斥
侂	亻广丿七
鼍	口口田一口电
庹	广廿尺
箨	竹扌又𰀁
萚	艹扌又𰀁
圫	土丿七
𬶍	鱼宀匕
哇	口土土
瓦	一𠄌㇈丶
娃	女土土
挖	扌宀八乙
袜	衤末
蛙	虫土土
娲	女口内
洼	氵土土
佤	亻瓦
窊	宀八瓜
腽	⺼日皿
坬	土瓜
畖	田瓜
外	夕卜
歪	不正
崴	山戊{一}女
完	宀元
晚	日⺈𫩏儿
玩	𤣩元
弯	亠{亦下}弓
碗	石宀夕㔾
湾	氵亠{亦下}弓
婉	女宀夕㔾
挽	扌⺈𫩏儿
腕	⺼宀夕㔾
宛	宀夕㔾
顽	元页
丸	力丶
卍	㇅丨一丨
惋	忄宀夕㔾
蜿	虫宀夕㔾
琬	𤣩宀夕㔾
纨	纟丸
婠	女宀㠯
皖	白宀元
绾	纟宀㠯
剜	宀夕㔾刂
菀	艹宀夕㔾
豌	豆宀夕㔾
畹	田宀夕㔾
烷	火宀元
脘	⺼宀元
芄	艹丸
塆	土亠{亦下}弓
椀	木宀夕㔾
𬇕	氵万
王	一土
望	亡月王
往	彳主
忘	亡心
网	冂乂乂
亡	亠𠃊
汪	氵王
妄	亡女
旺	日王
枉	木王
惘	忄冂䒑亡
罔	冂䒑亡
魍	鬼冂䒑亡
尢	𠂇乚
辋	车冂䒑亡
尪	尢王
为	力丶丶
位	亻立
微	彳山攵一几
未	一木
围	囗韦
卫	𰆊一
威	戊{一}女
味	口未
维	纟亻{隹右}
危	⺈厂㔾
委	禾女
伟	亻韦
谓	讠田⺝
唯	口亻{隹右}
慰	尸示寸心
尾	尸毛
喂	口田一{𧘇-丿}
魏	禾女鬼
薇	艹彳山攵一几
惟	忄亻{隹右}
违	⻌韦
韦	丰𠃌
畏	田一{𧘇-丿}
伪	亻为
尉	尸示寸
胃	田⺝
巍	山禾女鬼
蔚	艹尸示寸
偎	亻田一{𧘇-丿}
萎	艹禾女
苇	艹韦
炜	火韦
玮	𤣩韦
猥	犭田一{𧘇-丿}
娓	女尸毛
帷	巾亻{隹右}
纬	纟韦
渭	氵田⺝
桅	木⺈厂㔾
嵬	山鬼
猬	犭田⺝
隗	⻖鬼
葳	艹戊{一}女
痿	疒禾女
闱	门韦
煨	火田一{𧘇-丿}
诿	讠禾女
韪	日一龰韦
逶	辶禾女
帏	巾韦
圩	土于
潍	氵纟亻{隹右}
溦	氵山攵一几
鲔	鱼𠂇月
艉	舟尸毛
隈	⻖田一{𧘇-丿}
洧	氵𠂇月
沩	氵为
廆	广鬼
霨	雨尸示寸
涠	氵囗韦
亹	亠𦥑同且
碨	石田一{𧘇-丿}
煟	火田⺝
琟	𤣩亻{隹右}
硙	石山己
薳	艹辶土口𧘇
峗	山⺈厂㔾
洈	氵⺈厂㔾
螱	尸示寸虫
鳂	鱼田一{𧘇-丿}
鳚	鱼尸示寸
𣲗	氵韦
𫇭	艹为
𬀩	日韦
𬱟	⺈厂㔾页
𬶏	鱼⺈厂㔾
问	门口
文	亠乂
温	氵日皿
闻	门耳
稳	禾⺈彐心
吻	口勿
纹	纟文
雯	雨文
蚊	虫文
芠	艹文
瘟	疒日皿
紊	文糸
汶	氵文
玟	𤣩文
刎	勿刂
炆	火文
璺	𦥑同玉
阌	门爫冖又
辒	车日皿
榅	木日皿
蕰	艹氵日皿
鳁	鱼日皿
𫘜	马文
翁	公习习
嗡	口公习习
瓮	公瓦
蓊	艹公习习
蕹	艹亠乡亻{隹右}
滃	氵公习习
鹟	公习习鸟
𬭩	钅公习习
我	{戈丿}亅㇀
握	扌尸𠫔土
窝	宀八口内
卧	臣卜
沃	氵夭
倭	亻禾女
龌	止凵人尸𠫔土
蜗	虫口内
渥	氵尸𠫔土
斡	十十日𠆢斗
幄	巾尸𠫔土
挝	扌辶寸
莴	艹口内
硪	石我
肟	⺼一丂
偓	亻尸𠫔土
涴	氵宀夕㔾
踒	𧾷禾女
物	牜勿
五	一𫝀
武	戈一止
务	夂力
屋	尸𠫔土
舞	𠂉卌夕㐄
吴	口天
午	𠂉十
误	讠口天
雾	雨夂力
乌	丿𠃌㇉一
悟	忄五口
伍	亻五
呜	口乌
巫	工人人
吾	五口
污	氵一丂
捂	扌五口
勿	勹丿丿
兀	一儿
侮	亻𠂉母
唔	口五口
梧	木五口
妩	女无
芜	艹无
诬	讠工人人
坞	土乌
毋	{𠃊𠃌一(母-丶丶)}丿
晤	日五口
蜈	虫口{𠃑大}
邬	乌⻏
鹉	戈一止鸟
戊	戈丿
忤	忄𠂉十
骛	矛攵马
鹜	矛攵鸟
仵	亻𠂉十
婺	矛攵女
钨	钅乌
杌	木兀
焐	火五口
庑	广无
寤	宀爿五口
鋈	氵夭金
痦	疒五口
怃	忄无
牾	牜五口
圬	土一丂
浯	氵五口
芴	艹勿
迕	辶𠂉十
鼯	臼{鼠下}五口
旿	日𠂉十
靰	革兀
洿	氵大一丂
鹀	工人人鸟
郚	五口⻏
屼	山兀
珷	𤣩戈一止
铻	钅五口
峿	山五口
珸	𤣩五口
𣲘	氵无
西	一儿口
喜	士口䒑口
息	自心
细	纟田
希	㐅𠂇巾
习	𠃌冫
吸	口及
戏	又戈
洗	氵⺧儿
惜	忄卄一日
席	广廿巾
袭	龙衣
悉	釆心
嘻	口士口䒑口
析	木斤
稀	禾㐅𠂇巾
熙	𦣞巳灬
夕	丿㇇丶
晰	日木斤
溪	氵爫幺大
兮	八丂
牺	牜西
膝	⺼木人氺
媳	女自心
隙	⻖小小日
昔	卄一日
锡	钅日勿
嬉	女士口䒑口
熄	火自心
犀	尸八小牛
曦	日𦍌{戈亻人}丂
禧	礻士口䒑口
皙	木斤白
玺	⺈小玉
汐	氵夕
蜥	虫木斤
奚	爫幺大
唏	口㐅𠂇巾
羲	𦍌{戈亻人}丂
淅	氵木斤
徙	彳止龰
熹	士口䒑口灬
蟋	虫釆心
翕	𠆢一口习习
檄	木白方攵
僖	亻士口䒑口
窸	宀八釆心
铣	钅⺧儿
郗	㐅𠂇巾⻏
晞	日㐅𠂇巾
烯	火㐅𠂇巾
屃	尸贝
浠	氵㐅𠂇巾
阋	门臼儿
樨	木尸八小牛
傒	亻爫幺大
醯	酉㐬皿
隰	⻖日幺幺灬
螅	虫自心
爔	火𦍌{戈亻人}丂
屣	尸彳止龰
硒	石西
釐	未攵厂里
葸	艹田心
咥	口𠫔土
豨	豕㐅𠂇巾
禊	礻丰刀大
饩	饣气
郤	谷⻏
觋	工人人见
穸	宀八夕
嶲	山亻{隹右}{凹-一}
舄	臼勹灬
舾	舟西
谿	爫幺大谷
恓	忄西
蓰	艹彳止龰
鼷	臼{鼠下}爫幺大
粞	米西
巇	山虍一口䒑戈
憙	士口䒑口心
绤	纟谷
菥	艹木斤
枲	厶口木
潟	氵臼勹灬
肸	⺼八十
酅	山亻{隹右}冂八口⻏
睎	目㐅𠂇巾
觿	⺈用山亻{隹右}冂八口
嶍	山习习白
暿	日士口䒑口
俙	亻㐅𠂇巾
熻	火𠆢一口习习
饻	饣衣
鳛	鱼习习白
𠅤	亠田心
𫘬	马爫幺大
𬭳	钅士口䒑口
𬶮	鱼士口䒑口
下	一卜
夏	𦣻夂
侠	亻夹
霞	雨尸二コ又
瞎	目宀丰口
狭	犭夹
暇	日尸二コ又
峡	山夹
虾	虫下
辖	车宀丰口
匣	匚甲
瑕	𤣩尸二コ又
遐	辶尸二コ又
黠	{里}灬士口
呷	口甲
狎	犭甲
罅	缶虍乎
硖	石夹
柙	木甲
叚	尸二コ又
翈	甲习习
先	⺧儿
现	𤣩见
显	日业
线	纟戋
险	⻖佥
仙	亻山
咸	戊{一}口
鲜	鱼羊
限	⻖艮
闲	门木
陷	⻖⺈臼
县	且厶
献	十冂丷干犬
贤	丨丨又贝
嫌	女兼
羡	𦍌冫欠
弦	弓玄
掀	扌斤欠
宪	宀⺧儿
衔	彳一丁钅
娴	女门木
涎	氵廴正
馅	饣⺈臼
舷	舟玄
腺	⺼白水
暹	辶日亻{隹右}
苋	艹见
冼	冫⺧儿
藓	艹鱼羊
锨	钅斤欠
霰	雨卄一⺼攵
跹	𧾷辶千
忺	忄欠
痫	疒门木
祆	礻天
岘	山见
酰	酉⺧儿
跣	𧾷⺧儿
燹	豕豕火
狝	犭⺈小
蚬	虫见
猃	犭佥
籼	米山
鹇	门木鸟
筅	竹⺧儿
莶	艹佥
氙	气山
挦	扌彐寸
崄	山佥
缐	纟白水
孅	女戈人人韭
伭	亻玄
禒	礻彑𧰨
㬎	日幺幺灬
𪾢	目见
𫍯	讠戊{一}口
𬀪	日见
𬸣	宀𠀎八鸟
想	木目心
向	丿冂口
相	木目
像	亻{⺈丿口}𧰨
象	{⺈丿口}𧰨
响	口丿冂口
香	禾日
项	工页
乡	𠃋𠂈
享	亠口子
翔	羊习习
箱	竹木目
祥	礻羊
详	讠羊
湘	氵木目
厢	厂木目
襄	衣吅𠀎
镶	钅襄
橡	木{⺈丿口}𧰨
饷	饣丿冂口
骧	马襄
飨	乡𠆢丶艮
庠	广羊
缃	纟木目
芗	艹乡
鲞	龹鱼
瓖	𤣩襄
葙	艹木目
珦	𤣩丿冂口
𬙋	纟襄
小	亅八
笑	竹夭
消	氵⺌⺝
晓	日𫠠丿兀
萧	艹肀{⿰丿丨}八
效	亠父攵
销	钅⺌⺝
肖	⺌⺝
啸	口肀{⿰丿丨}八
孝	耂子
逍	辶⺌⺝
潇	氵艹肀{⿰丿丨}八
削	⺌⺝刂
嚣	口口页口口
霄	雨⺌⺝
宵	宀⺌⺝
哮	口耂子
箫	竹肀{⿰丿丨}八
筱	竹亻丨攵
枭	{鸟减一}木
硝	石⺌⺝
骁	马𫠠丿兀
淆	氵㐅𠂇月
魈	鬼⺌⺝
绡	纟⺌⺝
哓	口𫠠丿兀
鸮	口丂鸟
崤	山㐅𠂇月
枵	木口丂
猇	犭虍几
洨	氵亠父
翛	亻丨攵习习
虓	九虍几
涍	氵耂子
蟏	虫艹肀{⿰丿丨}八
敩	𰃮子攵
滧	氵亠父攵
皛	白白白
𫍲	讠𦥔又
些	止匕二
血	丿皿
谢	讠身寸
写	冖与
邪	牙⻏
协	十办
鞋	革土土
斜	𠆢一朩斗
泄	氵世
胁	⺼办
歇	曰勹𠃊人欠
屑	尸⺌⺝
械	木戈廾
携	扌亻{隹右}乃
谐	讠匕匕白
卸	𦈢卩
挟	扌夹
泻	氵冖与
懈	忄⺈用刀牛
蝎	虫曰勹𠃊人
蟹	⺈用刀牛虫
亵	衣扌丸
邂	辶⺈用刀牛
偕	亻匕匕白
榭	木身寸
燮	火火言又
楔	木丰刀大
撷	扌士口页
瀣	氵歺又韭
獬	犭⺈用刀牛
勰	力力力田心
廨	广⺈用刀牛
缬	纟士口页
躞	𧾷火火言又
绁	纟世
渫	氵世木
薤	艹歹韭
榍	木尸⺌⺝
揳	扌丰刀大
澥	氵⺈用刀牛
薢	艹⺈用刀牛
叶	口十
㙦	𠆢一朩斗土
偰	亻丰刀大
𤫉	𤣩火火言又
𬹼	止凵人介
新	立木斤
心	丶乚丶丶
信	亻亠二口
欣	斤欠
辛	立十
馨	士𠃜殳禾日
薪	艹立木斤
歆	立日欠
昕	日斤
衅	丿皿半
芯	艹心
鑫	金金金
忻	忄斤
锌	钅辛
炘	火斤
囟	丿囗㐅
伈	亻心
䜣	讠斤
𫷷	广钅欠
性	忄生
星	日生
形	开彡
兴	𭕄一八
醒	酉日生
幸	土丷干
型	开刂土
姓	女生
刑	开刂
腥	⺼日生
杏	木口
猩	犭日生
惺	忄日生
邢	开⻏
悻	忄土丷干
荥	艹冖水
擤	扌自田丌
陉	⻖𢀖
荇	艹彳一丁
饧	饣𠄎丿丿
骍	马辛
硎	石开刂
钘	钅开
瑆	𤣩日生
婞	女土丷干
铏	钅开刂
煋	火日生
𫰛	女𢀖
兄	口儿
胸	⺼勹凶
雄	𠂇厶亻{隹右}
凶	凵㐅
熊	厶⺝匕匕灬
汹	氵凶
匈	勹凶
芎	艹弓
讻	讠凶
夐	⺈冂人目攵
诇	讠冂口
修	亻丨攵彡
秀	禾乃
休	亻木
羞	⺶丑
袖	衤由
绣	纟禾乃
嗅	口自犬
朽	木丂
锈	钅禾乃
咻	口亻木
岫	山由
貅	豸亻木
馐	饣⺶丑
庥	广亻木
脩	亻丨攵⺝
溴	氵自犬
琇	𤣩禾乃
髹	E一厶彡亻木
鸺	亻木鸟
珛	𤣩𠂇月
滫	氵亻丨攵⺝
䗛	虫亻丨攵⺝
许	讠𠂉十
续	纟十乛大⺀
需	雨而
须	彡页
虚	虍业
徐	彳𠆢一朩
绪	纟耂日
序	广予
旭	九日
叙	𠆢一朩又
吁	口于
蓄	艹玄田
絮	女口糸
婿	女疋⺝
恤	忄丿皿
栩	木习习
墟	土虍业
诩	讠习习
煦	日句灬
胥	疋⺝
酗	酉凶
顼	𤣩页
勖	⺜目力
蓿	艹宀亻百
盱	目于
魆	鬼戈𠄌
洫	氵丿皿
溆	氵𠆢一朩又
糈	米疋⺝
谞	讠疋⺝
媭	彡页女
昫	日句
醑	酉疋⺝
珝	𤣩习习
旴	日于
湑	氵疋⺝
垿	土广予
㳚	氵戊丶
冔	⺜口于
𦈡	纟雨而
𬣙	讠于
选	⻌⺧儿
玄	亠幺
宣	宀一旦
旋	方𠂉疋
轩	车干
悬	且厶心
喧	口宀一旦
璇	𤣩方𠂉疋
眩	目玄
炫	火玄
萱	艹宀一旦
漩	氵方𠂉疋
绚	纟勹日
暄	日宀一旦
渲	氵宀一旦
煊	火宀一旦
泫	氵玄
铉	钅玄
瑄	𤣩宀一旦
烜	火一旦
癣	疒鱼羊
禤	礻⺫习习
谖	讠爫一𠂇又
儇	亻⺫一口𧘇
玹	𤣩玄
楦	木宀一旦
碹	石宀一旦
晅	日一旦
衒	彳一丁玄
翾	⺫一口𧘇习习
痃	疒玄
昡	日玄
咺	口一旦
暶	日方𠂉疋
愃	忄宀一旦
琄	𤣩口⺝
𫍽	讠⺫一口𧘇
𫓶	钅口⺝
𫠊	马玄
学	𰃮子
雪	雨彐
穴	宀八
薛	艹𠂤辛
靴	革亻𠤎
谑	讠虍𰀂
噱	口虍豕
踅	扌斤足
鳕	鱼雨彐
茓	艹宀八
峃	𰃮山
寻	彐寸
训	讠川
迅	辶⺄十
巡	辶巛
讯	讠⺄十
询	讠勹日
逊	⻌子小
循	彳𠂆十目
勋	口贝力
熏	千{里}灬
旬	勹日
驯	马川
荀	艹勹日
薰	艹千{里}灬
殉	歹勹日
醺	酉千{里}灬
洵	氵勹日
峋	山勹日
巽	巳巳共
珣	𤣩勹日
汛	氵⺄十
徇	彳勹日
浔	氵彐寸
埙	土口贝
恂	忄勹日
蕈	艹覀日十
鲟	鱼彐寸
曛	日千{里}灬
獯	犭千{里}灬
噀	口巳巳共
栒	木勹日
𫄸	纟千{里}灬
𬊈	火彐寸
𬍤	𤣩彐寸
𬘓	纟川
𬩽	彐寸阝
呀	口牙
亚	一业
压	厂土丶
雅	牙亻{隹右}
牙	𡕒丿
丫	丷丨
讶	讠牙
涯	氵厂土土
哑	口一业
崖	山厂土土
娅	女一业
押	扌甲
鸭	甲鸟
鸦	牙鸟
衙	彳一丁五口
芽	艹牙
伢	亻牙
琊	𤣩牙⻏
桠	木一业
睚	目厂土土
垭	土一业
岈	山牙
迓	辶牙
蚜	虫牙
玡	𤣩牙
揠	扌匚日女
猰	犭丰刀大
氩	气一业
砑	石牙
堐	土厂土土
眼	目艮
言	亠二口
严	一〢丷厂
烟	火因
演	氵宀一由八
验	马佥
研	石开
燕	廿{北口}灬
颜	亠丷厂彡页
掩	扌大电
延	廴正
厌	厂犬
艳	丰⺈巴
炎	火火
沿	氵几口
焰	火⺈臼
岩	山石
淹	氵大电
咽	口因
宴	宀日女
嫣	女正㇉一灬
妍	女开
彦	亠丷厂彡
雁	厂亻亻{隹右}
阎	门⺈臼
盐	土卜皿
焉	正㇉一灬
衍	彳一丁氵
檐	木⺈厂八亠二口
奄	大电
砚	石见
焱	火火火
俨	亻严
晏	日宀女
胭	⺼因
蜒	虫廴正
魇	厂犬鬼
阉	门大电
湮	氵覀土
琰	𤣩火火
筵	竹廴正
偃	亻匚日女
闫	门三
阏	门方𠆢⺀
恹	忄厂犬
谚	讠亠丷厂彡
兖	六允
堰	土匚日女
鄢	正㇉一灬⻏
滟	氵丰⺈巴
赝	厂亻亻{隹右}贝
唁	口亠二口
鼹	臼{鼠下}日宀女
芫	艹元
郾	匚日女⻏
酽	酉严
餍	厂犬𠆢丶艮
厣	厂犬甲
谳	讠十冂丷干犬
崦	山大电
弇	𠆢一口廾
黡	厂犬{里}灬
罨	罒大电
渰	氵𠆢一口廾
掞	扌火火
嬿	女廿{北口}灬
棪	木火火
扊	户火火
沇	氵允
甗	虍鬲瓦
殷	㐆殳
䶮	龙天
墕	土正㇉一灬
戭	宀一由八戈
漹	氵正㇉一灬
虤	虍几虍几
蝘	虫匚日女
觃	见子
𪩘	山十冂丷干犬
𫄧	纟廴正
𬙂	纟宀一由八
𬸘	匚日女鸟
样	木羊
阳	⻖日
杨	木𠄎丿丿
扬	扌𠄎丿丿
养	⺶乀{⿰丿丨}
洋	氵羊
仰	亻丿𠄌卩
央	{囗-一}一人
羊	丷一𰀁
痒	疒羊
漾	氵𦍌永
氧	气羊
恙	𦍌心
佯	亻羊
鸯	央鸟
殃	歹央
怏	忄央
秧	禾央
炀	火𠄎丿丿
泱	氵央
鞅	革央
徉	彳羊
烊	火羊
疡	疒𠄎丿丿
旸	日𠄎丿丿
飏	风𠄎丿丿
羕	𦍌永
蛘	虫羊
垟	土羊
玚	𤣩𠄎丿丿
咉	口央
钖	钅𠄎丿丿
要	覀女
摇	扌爫缶
药	艹纟勺
妖	女夭
腰	⺼覀女
咬	口亠父
遥	辶爫缶
耀	⺌一儿习习亻{隹右}
瑶	𤣩爫缶
姚	女兆
邀	辶白方攵
钥	钅月
夭	丿大
谣	讠爫缶
幺	𠃋厶
窑	宀八缶
尧	𫠠丿兀
吆	口幺
肴	㐅𠂇月
约	纟勺
曜	日习习亻{隹右}
窈	宀八幺力
杳	木日
舀	爫臼
爻	乂乂
鹞	爫缶鸟
徭	彳爫缶
轺	车刀口
鳐	鱼爫缶
崾	山覀女
窅	宀八目
峣	山𫠠丿兀
垚	土土土
珧	𤣩兆
靿	革幺力
猺	犭爫缶
媱	女爫缶
㙘	土覀女
也	𠃌丨乚
业	〢丷一
夜	亠亻{夜右下}
爷	父𰆊
野	里予
液	氵亠亻{夜右下}
耶	耳⻏
页	丆贝
曳	由㇂丿
冶	冫厶口
烨	火亻𠤎十
噎	口士冖一口䒑
腋	⺼亠亻{夜右下}
靥	厂犬面
椰	木耳⻏
掖	扌亠亻{夜右下}
晔	日亻𠤎十
邺	业⻏
谒	讠曰勹𠃊人
揶	扌耳⻏
铘	钅牙⻏
倻	亻耳⻏
馌	饣去皿
一	一
以	𠄌丶人
已	コ乚
意	立日心
衣	亠𧘇
亿	亻乙
易	日勿
依	亻衣
义	丶乂
异	己廾
疑	匕矢龴疋
议	讠义
医	匚矢
伊	亻尹
移	禾夕夕
忆	忄乙
艺	艹乙
亦	亠{亦下}
翼	习习田共
遗	⻌中一贝
益	丷一八皿
宜	宀且
椅	木大可
仪	亻义
逸	辶兔
姨	女夷
怡	忄厶口
抑	扌丿𠄌卩
毅	立𧰨殳
役	彳殳
译	讠又𰀁
夷	一弓人
溢	氵丷一八皿
咦	口夷
倚	亻大可
矣	厶矢
谊	讠宀且
乙	乙
蚁	虫义
奕	亠{亦下}大
漪	氵犭大可
疫	疒殳
绎	纟又𰀁
裔	衣冂八口
揖	扌口耳
颐	𦣞页
驿	马又𰀁
弈	亠{亦下}廾
懿	士冖一口䒑冫欠心
邑	口巴
熠	火习习白
屹	山𠂉乙
沂	氵斤
羿	习习廾
诣	讠匕日
翌	习习立
轶	车丿夫
呓	口艹乙
翊	立习习
蜴	虫日勿
弋	𫠠丶
咿	口亻尹
旖	方𠂉大可
祎	礻韦
臆	⺼立日心
彝	彑米糸廾
贻	贝厶口
噫	口立日心
佚	亻丿夫
迤	辶𠂉也
壹	士冖一口䒑
缢	纟丷一八皿
翳	匚矢殳习习
胰	⺼夷
痍	疒夷
薏	艹立日心
嶷	山匕矢龴疋
饴	饣厶口
苡	艹𠄌丶人
悒	忄口巴
猗	犭大可
诒	讠厶口
黟	{里}灬夕夕
峄	山又𰀁
镱	钅立日心
怿	忄又𰀁
眙	目厶口
肄	匕矢聿
铱	钅衣
挹	扌口巴
乂	丿乀
刈	㐅刂
癔	疒立日心
镒	钅丷一八皿
埸	土日勿
佾	亻八⺝
圯	土巳
瘗	疒夹土
燚	火火火火
劓	自田丌刂
殪	歹士冖一口䒑
浥	氵口巴
扆	户衣
廙	广田共
簃	竹禾夕夕
嫕	女匚矢心
舣	舟义
杙	木弋
钇	钅乙
鹢	丷一八皿鸟
宧	宀𦣞
洢	氵亻尹
酏	酉也
繄	匚矢殳糸
裛	衣口巴
椸	木方𠂉也
踦	𧾷大可
扅	户夕夕
佁	亻厶口
勚	世贝力
匜	匚也
鹝	鬲鸟
㑊	亻亠{亦下}
枍	木八丂
潩	氵田共
螠	虫丷一八皿
𫄷	纟立日心
𫖮	山己页
𬟁	艹鬲鸟
𬬩	钅弋
𬺈	止凵人大可
因	囗大
音	立日
引	弓丨
隐	⻖⺈彐心
银	钅艮
阴	⻖月
印	𠀉卩
吟	口𠆢一㇇
饮	饣欠
淫	氵爫丿士
姻	女因
尹	⺕丿
茵	艹因
瘾	疒⻖⺈彐心
胤	儿幺⺝
荫	艹⻖月
寅	宀一由八
垠	土艮
氤	气因
蚓	虫弓丨
喑	口立日
洇	氵因
龈	止凵人艮
鄞	廿中王⻏
夤	夕宀一由八
窨	宀八立日
霪	雨氵爫丿士
狺	犭亠二口
愔	忄立日
堙	土覀土
訚	门亠二口
吲	口弓丨
铟	钅因
嚚	口口臣口口
禋	礻覀土
骃	马因
慭	来犬心
硍	石艮
珢	𤣩艮
茚	艹𠀉卩
蟫	虫覀日十
龂	止凵人斤
崟	山金
溵	氵㐆殳
歅	覀土欠
䲟	鱼𠀉卩
𬘡	纟因
𬤇	讠覀土
𬮱	门覀土
应	广𭕄一
影	日亠口小彡
英	艹央
营	艹冖口口
迎	辶丿𠄌卩
硬	石更
鹰	广亻亻{隹右}鸟
赢	亡口月凡贝
映	日央
莹	艹冖玉
盈	乃又皿
婴	贝贝女
樱	木贝贝女
颖	匕禾页
莺	艹冖鸟
蝇	虫口电
嬴	亡口月凡女
萤	艹冖虫
荧	艹冖火
萦	艹冖糸
瑛	𤣩艹央
缨	纟贝贝女
瀛	氵亡口月凡女
嘤	口贝贝女
膺	广亻亻{隹右}⺝
滢	氵艹冖玉
鹦	贝贝女鸟
罂	贝贝缶
璎	𤣩贝贝女
郢	口王⻏
颍	匕水页
茔	艹冖土
楹	木乃又皿
撄	扌贝贝女
潆	氵艹冖糸
媵	月龹女
瘿	疒贝贝女
锳	钅艹央
蓥	艹冖金
溁	氵艹冖木
媖	女艹央
䓨	艹冖缶
用	冂𰀁
永	丶水
拥	扌用
勇	龴用力
佣	亻用
庸	广肀月
泳	氵永
雍	亠乡亻{隹右}
咏	口永
甬	龴用
慵	忄广肀月
俑	亻龴用
恿	龴用心
臃	⺼亠乡亻{隹右}
蛹	虫龴用
邕	巛口巴
踊	𧾷龴用
墉	土广肀月
镛	钅广肀月
颙	田冂一丶页
痈	疒用
壅	亠乡亻{隹右}土
饔	亠乡亻{隹右}𠆢丶艮
鳙	鱼广肀月
澭	氵亠乡亻{隹右}
鄘	广肀月⻏
埇	土龴用
栐	木永
喁	口田冂一丶
㶲	火用
鲬	鱼龴用
有	𠂇月
又	㇇乀
由	丨田
友	𠂇又
游	氵方𠂉子
右	𠂇口
优	亻尤
犹	犭尤
幽	山幺幺
油	氵由
尤	尢丶
忧	忄尤
悠	亻丨攵心
诱	讠禾乃
幼	幺力
佑	亻𠂇口
邮	由⻏
黝	{里}灬幺力
呦	口幺力
攸	亻丨攵
鱿	鱼尤
酉	西一
繇	爫缶丿糸
柚	木由
祐	礻𠂇口
铀	钅由
猷	丷酉犬
釉	采由
莠	艹禾乃
囿	囗𠂇月
鼬	臼{鼠下}由
宥	宀𠂇月
莜	艹亻丨攵
疣	疒尤
侑	亻𠂇月
牖	片户甫
蝣	虫方𠂉子
蚴	虫幺力
羑	𦍌久
蚰	虫由
莸	艹犭尤
卣	⺊囗コ
麀	鹿匕
耰	耒{戞-戈}心夂
浟	氵亻丨攵
槱	木酉灬
铕	钅𠂇月
鲉	鱼由
𬨎	车丷酉
与	㇉一一
于	一十
语	讠五口
雨	一冂丨丶丶丶丶
玉	王丶
余	𠆢一朩
遇	辶田冂一丶
欲	谷欠
羽	习习
宇	宀于
鱼	⺈田一
预	予页
御	彳𦈢卩
郁	𠂇月⻏
豫	予{⺈丿口}𧰨
域	土戈口{一}
狱	犭讠犬
予	龴乛亅
愈	𠆢一月刂心
浴	氵谷
誉	𭕄一八亠二口
愉	忄𠆢一月刂
愚	田冂一丶心
於	方𠆢⺀
裕	衤谷
娱	女口天
瑜	𤣩𠆢一月刂
喻	口𠆢一月刂
寓	宀田冂一丶
渔	氵鱼
虞	虍口{𠃑大}
俞	𠆢一月刂
禹	丿中冂一丶
煜	火日立
舆	𦥑车一八
谕	讠𠆢一月刂
逾	辶𠆢一月刂
榆	木𠆢一月刂
屿	山与
钰	钅玉
驭	马又
渝	氵𠆢一月刂
迂	辶于
淤	氵方𠆢⺀
毓	𠂉母厶一𫶧
瑀	𤣩禹
妤	女予
昱	日立
隅	⻖田冂一丶
禺	田冂一丶
芋	艹于
聿	肀干
臾	𦥑人
揄	扌𠆢一月刂
峪	山谷
觎	𠆢一月刂见
妪	女区
谀	讠𦥑人
腴	⺼𦥑人
盂	于皿
彧	𢦑口{一}
庾	广𦥑人
瘀	疒方𠆢⺀
燏	火矛冂八口
棫	木戈口{一}
蜮	虫戈口{一}
圄	囗五口
竽	竹于
欤	与欠
萸	艹𦥑人
鹬	矛冂八口鸟
鬻	弓弓米鬲
龉	止凵人五口
窳	宀八瓜瓜
圉	囗土丷干
纡	纟于
狳	犭𠆢一朩
俣	亻口天
燠	火丿冂釆大
瘐	疒𦥑人
伛	亻区
饫	饣夭
淯	氵亠厶⺝
阈	门戈口{一}
蝓	虫𠆢一月刂
舁	臼廾
遹	辶矛冂八口
雩	雨一丂
鹆	谷鸟
窬	宀八𠆢一月刂
熨	尸示寸火
玙	𤣩与
嵛	山𠆢一月刂
堉	土亠厶⺝
褕	衤𠆢一月刂
矞	矛冂八口
畬	𠆢一朩田
嵎	山田冂一丶
蓣	艹予页
髃	冎⺼田冂一丶
滪	氵予页
潏	氵矛冂八口
悆	𠆢一朩心
敔	五口攵
邘	于⻏
鄅	禹⻏
艅	舟𠆢一朩
㺄	犭𠆢一月刂
原	厂白小
远	⻌元
员	口贝
元	一兀
院	⻖宀元
愿	厂白小心
园	囗元
源	氵厂白小
圆	囗口贝
缘	纟彑𧰨
怨	夕㔾心
援	扌爫一𠂇又
袁	土口𧘇
辕	车土口𧘇
渊	氵丿米丨
冤	冖兔
媛	女爫一𠂇又
苑	艹夕㔾
猿	犭土口𧘇
鸳	夕㔾鸟
垣	土一旦
鸢	弋鸟
沅	氵元
爰	爫一𠂇又
瑗	𤣩爫一𠂇又
塬	土厂白小
鼋	元口电
掾	扌彑𧰨
垸	土宀元
螈	虫厂白小
橼	木纟彑𧰨
蜎	虫口⺝
嫄	女厂白小
箢	竹宀夕㔾
湲	氵爫一𠂇又
眢	夕㔾目
妧	女元
羱	羊厂白小
𫘪	马厂白小
越	土龰戈𠄌
月	⺆二
跃	𧾷夭
岳	丘山
悦	忄丷兄
曰	囗一
阅	门丷兄
粤	丿囗米丂
玥	𤣩月
钺	钅戈𠄌
樾	木土龰戈𠄌
刖	月刂
彟	彐寸艹亻{隹右}又
瀹	氵𠆢一𠱠冂卄
龠	𠆢一𠱠冂卄
爚	火𠆢一𠱠冂卄
籥	竹𠆢一𠱠冂卄
𫐄	车兀
𬸚	犭讠犬鸟
云	一一厶
运	辶云
晕	日冖车
允	厶儿
韵	立日匀
芸	艹云
孕	乃子
蕴	艹纟日皿
匀	勹冫
陨	⻖口贝
酝	酉云
愠	忄日皿
氲	气日皿
耘	耒云
昀	日匀
纭	纟云
殒	歹口贝
韫	韦日皿
郓	冖车⻏
赟	文戈一止贝
恽	忄冖车
鋆	土匀金
郧	口贝⻏
狁	犭允
沄	氵云
妘	女云
缊	纟日皿
煴	火日皿
筼	竹口贝
涢	氵口贝
馧	禾日日皿
𫖳	尹口页
咋	口乍
砸	石匚巾
杂	九木
咂	口匚巾
匝	匚巾
扎	扌乚
臜	⺼⺧儿⺧儿贝
拶	扌巛夕
在	𠂇丨土
再	一冉
载	戈十车
灾	宀火
宰	宀辛
栽	戈十木
哉	戈十口
仔	亻子
崽	山田心
甾	巛田
咱	口自
赞	⺧儿⺧儿贝
暂	车斤日
簪	竹兂兂曰
瓒	𤣩⺧儿⺧儿贝
錾	车斤金
糌	米夂卜日
趱	土龰⺧儿⺧儿贝
昝	夂卜日
酂	⺧儿⺧儿贝⻏
寁	宀{十⺕}龰
脏	⺼广土
葬	艹歹匕廾
赃	贝广土
臧	𠃊丆戊臣
奘	爿士大
牂	爿羊
驵	马且
早	日十
造	辶⺧口
遭	辶艹曲曰
糟	米艹曲曰
澡	氵口口口木
躁	𧾷口口口木
燥	火口口口木
凿	凵业丷干
噪	口口口口木
灶	火土
枣	朿⺀
皂	白七
藻	艹氵口口口木
蚤	叉虫
唣	口白七
璪	𤣩口口口木
慥	忄辶⺧口
簉	竹辶⺧口
𥖨	石口口口木
则	贝刂
责	龶贝
择	扌又𰀁
泽	氵又𰀁
啧	口龶贝
仄	厂人
笮	竹乍
帻	巾龶贝
赜	𦣞龶贝
昃	日厂人
舴	舟乍
箦	竹龶贝
迮	辶乍
贼	贝戈十
鲗	鱼贝刂
怎	乍心
谮	讠兂兂曰
增	土丷囗⺌日
赠	贝丷囗⺌日
憎	忄丷囗⺌日
锃	钅口王
缯	纟丷囗⺌日
甑	丷囗⺌日瓦
罾	罒丷囗⺌日
矰	矢丷囗⺌日
鄫	丷囗⺌日⻏
综	纟宀示
䎖	丷囗⺌日习习
炸	火乍
眨	目乏
诈	讠乍
乍	𠂉丨二
渣	氵木旦
札	木乚
闸	门甲
榨	木宀八乍
吒	口丿七
咤	口宀丿七
蚱	虫乍
铡	钅贝刂
楂	木木旦
鲊	鱼乍
揸	扌木旦
砟	石乍
哳	口扌斤
奓	大夕夕
拃	扌乍
挓	扌宀丿七
痄	疒乍
劄	竹𠆢一口刂
霅	雨亠二口
柞	木乍
䃎	石大夕夕
溠	氵⺶工
鲝	⺶鱼
齇	自田丌虍且
寨	宀𠀎八木
宅	宀丿七
摘	扌亠丷冂古
债	亻龶贝
窄	宀八乍
斋	文而
瘵	疒𱼀龴示
豸	丿⺀丿㇁丿丿
站	立占
战	占戈
展	尸卄一{𧘇-丿}
占	⺊囗
斩	车斤
沾	氵占
蘸	艹酉亻{隹右}灬
绽	纟宀一龰
栈	木戋
盏	戋皿
詹	⺈厂八亠二口
湛	氵卄二匸八
崭	山车斤
瞻	目⺈厂八亠二口
辗	车尸卄一{𧘇-丿}
毡	毛占
旃	方𠂉丹
谵	讠⺈厂八亠二口
搌	扌尸卄一{𧘇-丿}
飐	风占
鹯	亠囗口旦鸟
偡	亻卄二匸八
栴	木𠂉丹
鳣	鱼亠囗口旦
𫗴	饣亠囗口旦
张	弓长
章	立日十
掌	龸口手
丈	一丿乀
帐	巾长
仗	亻丈
障	⻖立日十
涨	氵弓长
杖	木丈
账	贝长
璋	𤣩立日十
胀	⺼长
彰	立日十彡
蟑	虫立日十
瘴	疒立日十
樟	木立日十
漳	氵立日十
獐	犭立日十
嶂	山立日十
幛	巾立日十
鄣	立日十⻏
嫜	女立日十
暲	日立日十
仉	亻几
找	扌戈
照	日刀口灬
招	扌刀口
赵	土龰㐅
罩	罒⺊日十
着	⺶目
爪	𠂆丨乀
昭	日刀口
兆	儿{冫⿱丿丶}
诏	讠刀口
沼	氵刀口
肇	户攵聿
钊	钅刂
棹	木⺊日十
笊	竹爪
曌	日月宀八工
啁	口⺆土口
旐	方𠂉兆
𬬿	钅刀口
𬶐	鱼兆
这	⻌文
者	耂日
哲	扌斤口
遮	辶广廿灬
浙	氵扌斤
辙	车亠厶⺝攵
辄	车耳𠃊
褶	衤习习白
蛰	扌丸虫
蔗	艹广廿灬
蜇	扌斤虫
鹧	广廿灬鸟
喆	士口士口
谪	讠亠丷冂古
赭	赤耂日
柘	木石
磔	石夕㐄木
锗	钅耂日
啫	口耂日
晢	扌斤日
詟	龙亠二口
䗪	广廿灬虫
真	十{具-八}八
阵	⻖车
震	雨辰
镇	钅十{具-八}八
珍	𤣩𠆢彡
针	钅十
振	扌辰
朕	月丷天
侦	亻⺊贝
贞	⺊贝
枕	木冖儿
诊	讠𠆢彡
甄	覀土瓦
帧	巾⺊贝
斟	卄二匸八斗
祯	礻⺊贝
臻	𠫔土𡗗禾
桢	木⺊贝
箴	竹戊{一}口
缜	纟十{具-八}八
圳	土川
榛	木𡗗禾
赈	贝辰
蓁	艹𡗗禾
禛	礻十{具-八}八
疹	疒𠆢彡
砧	石占
鸩	冖儿鸟
轸	车𠆢彡
稹	禾十{具-八}八
浈	氵⺊贝
瑧	𤣩𡗗禾
畛	田𠆢彡
胗	⺼𠆢彡
鬒	E一厶彡十{具-八}八
袗	衤𠆢彡
葴	艹戊{一}口
揕	扌卄二匸八
昣	日𠆢彡
纼	纟弓丨
正	一止
整	束攵正
政	正攵
争	⺈{肀亅}
证	讠正
征	彳正
郑	丷天⻏
睁	目⺈{肀亅}
挣	扌⺈{肀亅}
怔	忄正
症	疒正
蒸	艹了水一灬
铮	钅⺈{肀亅}
筝	竹⺈{肀亅}
狰	犭⺈{肀亅}
拯	扌丞
峥	山⺈{肀亅}
钲	钅正
诤	讠⺈{肀亅}
烝	了水一灬
只	口八
知	矢口
直	十{具-八}
至	𠫔土
之	丶㇇乀
指	扌匕日
值	亻十{具-八}
制	牛冂刂
支	十又
志	士心
止	丨一⺊
治	氵厶口
质	𠂆十贝
置	罒十{具-八}
致	𠫔土攵
职	耳只
智	矢口日
纸	纟氏
织	纟只
执	扌丸
枝	木支
植	木十{具-八}
旨	匕日
芝	艹之
吱	口支
肢	⺼支
侄	亻𠫔土
脂	⺼匕日
址	土止
汁	氵十
滞	氵{卅}冖巾
稚	禾亻{隹右}
掷	扌丷天⻏
秩	禾丿夫
窒	宀八𠫔土
芷	艹止
挚	扌丸手
蜘	虫矢口
帜	巾只
炙	𱼀火
趾	𧾷止
咫	尺只
痣	疒士心
徵	彳攵山一王
雉	矢亻{隹右}
祗	礻氐
栀	木𠂆一㔾
痔	疒土寸
栉	木艹𰆊
祉	礻止
桎	木𠫔土
蛭	虫𠫔土
鸷	扌丸鸟
郅	𠫔土⻏
踯	𧾷丷天⻏
贽	扌丸贝
陟	⻖止𣥂
骘	⻖止𣥂马
彘	彑匕矢匕
跖	𧾷石
轾	车𠫔土
摭	扌广廿灬
枳	木只
酯	酉匕日
帙	巾丿夫
禔	礻日一龰
卮	𠂆一㔾
沚	氵止
胝	⺼氐
觯	⺈用丷田十
絷	扌丸糸
埴	土十{具-八}
轵	车只
黹	业⺌冂小
踬	𧾷𠂆十贝
忮	忄支
晊	日𠫔土
畤	田土寸
滍	氵屮一虫
稙	禾十{具-八}
扺	扌氏
铚	钅𠫔土
锧	钅𠂆十贝
疐	十冖田疋
跱	𧾷土寸
庤	广土寸
泜	氵氐
梽	木士心
榰	木老日
𦭜	艹只
𬃊	木𠂆十贝
中	口丨
终	纟冬
众	人人人
钟	钅中
忠	中心
仲	亻中
衷	衣中
肿	⺼中
冢	冖豖
踵	𧾷重
盅	中皿
锺	钅重
舯	舟中
螽	冬虫虫
柊	木冬
茽	艹亻中
周	⺆土口
州	丶丿丶丨丶丨
皱	⺈彐皮
洲	氵州
咒	口口几
宙	宀由
舟	丿丹丶
骤	马耳又丿{水}
粥	弓弓米
肘	⺼寸
轴	车由
昼	尺旦
帚	彐冖巾
胄	由⺝
纣	纟寸
绉	纟⺈彐
诌	讠⺈彐
妯	女由
碡	石龶母
籀	竹扌{丿𠄌丶}刀田
酎	酉寸
辀	车舟
赒	贝⺆土口
鸼	舟鸟
荮	艹纟寸
婤	女⺆土口
㑇	亻⺈彐
㤘	忄⺈彐
住	亻主
主	亠土
注	氵主
助	且力
著	艹耂日
朱	丿未
珠	𤣩丿未
诸	讠耂日
逐	辶豕
竹	亇亇
猪	犭耂日
祝	礻兄
筑	竹工凡
柱	木主
驻	马主
嘱	口尸禹
烛	火虫
煮	耂日灬
蛛	虫丿未
株	木丿未
铸	钅{寿上丰}寸
诛	讠丿未
竺	竹二
瞩	目尸禹
伫	亻㝉
拄	扌主
侏	亻丿未
贮	贝㝉
茱	艹丿未
洙	氵丿未
蛀	虫主
渚	氵耂日
箸	竹耂日
炷	火主
铢	钅丿未
躅	𧾷⺫勹虫
苎	艹㝉
杼	木予
翥	耂日习习
槠	木讠耂日
麈	鹿主
潴	氵犭耂日
舳	舟由
邾	丿未⻏
纻	纟㝉
橥	犭耂日木
砫	石主
柷	木兄
疰	疒主
蠋	虫⺫勹虫
瘃	疒豖
𬣞	讠㝉
抓	扌爪
髽	E一厶彡土人人
拽	扌曳
转	车专
专	土龴
赚	贝兼
砖	石专
撰	扌巳巳共
篆	竹彑𧰨
馔	饣巳巳共
颛	山而页
啭	口车专
僎	亻巳巳共
瑑	𤣩彑𧰨
䏝	⺼专
装	丬士衣
状	丬犬
庄	广土
撞	扌立里
壮	丬士
妆	丬女
桩	木广土
追	辶𠂤
坠	⻖人土
缀	纟又又又又
锥	钅亻{隹右}
惴	忄山而
赘	龶{⺈}攵贝
椎	木亻{隹右}
骓	马亻{隹右}
缒	纟辶𠂤
隹	亻{隹右}
准	冫亻{隹右}
谆	讠亠口子
肫	⺼屯
窀	宀八屯
衠	彳一丁十{具-八}八
𬘯	纟亠口子
桌	⺊日木
卓	⺊日十
捉	扌足
琢	𤣩豖
灼	火勺
拙	扌出
浊	氵虫
镯	钅⺫勹虫
酌	酉勺
啄	口豖
茁	艹出
涿	氵豖
擢	扌习习亻{隹右}
斫	石斤
濯	氵习习亻{隹右}
倬	亻⺊日十
浞	氵足
诼	讠豖
棁	木丷兄
禚	礻𦍌灬
椓	木豖
晫	日⺊日十
叕	又又又又
汋	氵勺
䓬	艹⺊日十
䦃	钅艹耂日
𬸦	方𠂉矢鸟
子	了一
自	丿目
字	宀子
资	冫欠贝
紫	止匕糸
姿	冫欠女
滋	氵丷一幺幺
姊	女𠂔
咨	冫欠口
梓	木辛
孜	子攵
渍	氵龶贝
籽	米子
恣	冫欠心
龇	止凵人止匕
辎	车巛田
淄	氵巛田
眦	目止匕
滓	氵宀辛
嗞	口丷一幺幺
髭	E一厶彡止匕
孳	丷一幺幺子
缁	纟巛田
笫	竹𠂔
锱	钅巛田
秭	禾𠂔
赀	止匕贝
訾	止匕亠二口
觜	止匕⺈用
嵫	山丷一幺幺
趑	土龰冫欠
孖	子子
粢	冫欠米
鲻	鱼巛田
镃	钅丷一幺幺
耔	耒子
鼒	才爿片目
虸	虫子
鄑	亚日⻏
总	丷口心
宗	宀示
纵	纟人人
踪	𧾷宀示
棕	木宀示
鬃	E一厶彡宀示
粽	米宀示
偬	亻勹丿丿丶心
倧	亻宀示
鬷	鬲凶儿夂
腙	⺼宀示
疭	疒人人
走	土龰
奏	𡗗天
揍	扌𡗗天
邹	⺈彐⻏
诹	讠耳又
驺	马⺈彐
陬	⻖耳又
鄹	耳又丿{水}⻏
鲰	鱼耳又
组	纟且
足	口龰
族	方𠂉矢
祖	礻且
阻	⻖且
租	禾且
诅	讠且
俎	人人且
镞	钅方𠂉矢
菹	艹氵且
崒	山亠人人十
珇	𤣩且
钻	钅占
攥	扌竹目大糸
纂	竹目大糸
缵	纟⺧儿⺧儿贝
躜	𧾷⺧儿⺧儿贝
最	日耳又
嘴	口止匕⺈用
罪	罒非
醉	酉亠人人十
蕞	艹日耳又
槜	木亻{隹右}乃
尊	丷酉寸
遵	辶丷酉寸
樽	木丷酉寸
鳟	鱼丷酉寸
撙	扌丷酉寸
噂	口丷酉寸
僔	亻丷酉寸
嶟	山丷酉寸
𨱔	钅丷酉寸
做	亻古攵
作	亻乍
坐	土人人
左	𠂇工
座	广土人人
昨	日乍
佐	亻𠂇工
祚	礻乍
嘬	口日耳又
酢	酉乍
怍	忄乍
胙	⺼乍
唑	口土人人
捽	扌亠人人十
阼	⻖乍
岞	山乍